Orthogroup	protein_mansoni	resultado_cel	resultado_dme	resultado_sce	Total
OG0000000	113	0	0	0	113
OG0000001	1	0	75	0	76
OG0000002	0	71	0	0	71
OG0000003	0	67	0	0	67
OG0000004	0	52	0	0	52
OG0000005	50	0	0	0	50
OG0000006	0	0	0	48	48
OG0000007	0	44	0	0	44
OG0000008	0	44	0	0	44
OG0000009	2	41	0	0	43
OG0000010	11	15	16	0	42
OG0000011	4	28	9	1	42
OG0000012	1	2	36	0	39
OG0000013	0	39	0	0	39
OG0000014	0	0	38	1	39
OG0000015	1	35	1	0	37
OG0000016	0	2	33	1	36
OG0000017	0	35	0	0	35
OG0000018	2	9	21	1	33
OG0000019	9	10	11	3	33
OG0000020	32	0	0	0	32
OG0000021	1	20	11	0	32
OG0000022	0	32	0	0	32
OG0000023	0	10	21	0	31
OG0000024	0	31	0	0	31
OG0000025	0	0	29	2	31
OG0000026	0	30	0	0	30
OG0000027	0	0	30	0	30
OG0000028	1	23	5	0	29
OG0000029	10	10	8	1	29
OG0000030	28	0	0	0	28
OG0000031	0	28	0	0	28
OG0000032	0	28	0	0	28
OG0000033	0	0	28	0	28
OG0000034	0	0	0	28	28
OG0000035	0	27	0	0	27
OG0000036	17	4	1	4	26
OG0000037	4	17	3	2	26
OG0000038	1	22	3	0	26
OG0000039	3	7	13	2	25
OG0000040	1	22	2	0	25
OG0000041	0	25	0	0	25
OG0000042	0	2	23	0	25
OG0000043	0	25	0	0	25
OG0000044	5	10	6	3	24
OG0000045	23	0	1	0	24
OG0000046	4	15	4	1	24
OG0000047	0	24	0	0	24
OG0000048	0	24	0	0	24
OG0000049	0	24	0	0	24
OG0000050	9	7	7	0	23
OG0000051	10	3	9	1	23
OG0000052	6	10	5	2	23
OG0000053	0	23	0	0	23
OG0000054	0	22	0	1	23
OG0000055	0	0	23	0	23
OG0000056	22	0	0	0	22
OG0000057	22	0	0	0	22
OG0000058	6	7	7	2	22
OG0000059	0	22	0	0	22
OG0000060	0	22	0	0	22
OG0000061	20	1	0	0	21
OG0000062	2	8	8	3	21
OG0000063	1	19	1	0	21
OG0000064	20	0	0	0	20
OG0000065	9	5	5	1	20
OG0000066	1	6	12	1	20
OG0000067	1	17	2	0	20
OG0000068	1	1	18	0	20
OG0000069	0	20	0	0	20
OG0000070	0	20	0	0	20
OG0000071	1	2	16	0	19
OG0000072	0	19	0	0	19
OG0000073	0	18	1	0	19
OG0000074	18	0	0	0	18
OG0000075	18	0	0	0	18
OG0000076	2	0	16	0	18
OG0000077	4	6	6	2	18
OG0000078	4	5	7	2	18
OG0000079	2	0	16	0	18
OG0000080	1	1	16	0	18
OG0000081	0	2	16	0	18
OG0000082	0	0	18	0	18
OG0000083	0	0	18	0	18
OG0000084	0	0	0	18	18
OG0000085	8	5	3	1	17
OG0000086	5	9	2	1	17
OG0000087	1	4	10	2	17
OG0000088	1	8	7	1	17
OG0000089	17	0	0	0	17
OG0000090	3	9	4	1	17
OG0000091	4	4	8	1	17
OG0000092	2	4	11	0	17
OG0000093	0	2	9	6	17
OG0000094	0	17	0	0	17
OG0000095	0	16	1	0	17
OG0000096	0	0	0	17	17
OG0000097	2	3	11	0	16
OG0000098	14	1	1	0	16
OG0000099	2	0	13	1	16
OG0000100	0	15	0	1	16
OG0000101	0	16	0	0	16
OG0000102	0	15	1	0	16
OG0000103	0	16	0	0	16
OG0000104	0	0	16	0	16
OG0000105	0	0	16	0	16
OG0000106	0	0	16	0	16
OG0000107	5	4	3	3	15
OG0000108	12	1	2	0	15
OG0000109	4	4	3	4	15
OG0000110	4	4	5	2	15
OG0000111	6	4	3	2	15
OG0000112	5	5	4	1	15
OG0000113	10	3	1	1	15
OG0000114	2	7	3	3	15
OG0000115	1	4	7	3	15
OG0000116	1	14	0	0	15
OG0000117	0	0	15	0	15
OG0000118	0	0	14	1	15
OG0000119	1	6	6	1	14
OG0000120	4	2	5	3	14
OG0000121	4	4	6	0	14
OG0000122	4	4	4	2	14
OG0000123	3	9	2	0	14
OG0000124	3	4	4	3	14
OG0000125	4	7	2	1	14
OG0000126	3	9	1	1	14
OG0000127	4	4	3	3	14
OG0000128	0	14	0	0	14
OG0000129	0	12	1	1	14
OG0000130	0	14	0	0	14
OG0000131	0	14	0	0	14
OG0000132	0	12	2	0	14
OG0000133	0	14	0	0	14
OG0000134	0	0	14	0	14
OG0000135	0	0	14	0	14
OG0000136	1	4	6	2	13
OG0000137	5	6	0	2	13
OG0000138	1	1	11	0	13
OG0000139	13	0	0	0	13
OG0000140	3	6	4	0	13
OG0000141	4	5	3	1	13
OG0000142	3	5	3	2	13
OG0000143	4	2	5	2	13
OG0000144	3	5	2	3	13
OG0000145	1	7	2	3	13
OG0000146	2	3	7	1	13
OG0000147	3	2	6	2	13
OG0000148	1	5	6	1	13
OG0000149	1	1	11	0	13
OG0000150	2	8	1	2	13
OG0000151	1	4	8	0	13
OG0000152	0	13	0	0	13
OG0000153	0	13	0	0	13
OG0000154	0	13	0	0	13
OG0000155	0	2	11	0	13
OG0000156	0	0	13	0	13
OG0000157	0	0	13	0	13
OG0000158	3	8	1	0	12
OG0000159	2	5	5	0	12
OG0000160	2	7	1	2	12
OG0000161	5	1	5	1	12
OG0000162	3	3	3	3	12
OG0000163	2	4	2	4	12
OG0000164	4	2	3	3	12
OG0000165	3	3	2	4	12
OG0000166	1	7	2	2	12
OG0000167	5	3	3	1	12
OG0000168	4	2	6	0	12
OG0000169	12	0	0	0	12
OG0000170	2	2	8	0	12
OG0000171	2	6	3	1	12
OG0000172	2	0	10	0	12
OG0000173	3	4	4	1	12
OG0000174	2	7	1	2	12
OG0000175	1	7	3	1	12
OG0000176	0	12	0	0	12
OG0000177	0	12	0	0	12
OG0000178	0	8	1	3	12
OG0000179	0	12	0	0	12
OG0000180	0	12	0	0	12
OG0000181	0	0	12	0	12
OG0000182	0	0	12	0	12
OG0000183	3	7	0	1	11
OG0000184	4	1	4	2	11
OG0000185	5	2	2	2	11
OG0000186	3	4	2	2	11
OG0000187	2	2	4	3	11
OG0000188	3	4	2	2	11
OG0000189	1	4	5	1	11
OG0000190	3	3	2	3	11
OG0000191	2	5	4	0	11
OG0000192	6	2	3	0	11
OG0000193	7	1	3	0	11
OG0000194	11	0	0	0	11
OG0000195	3	3	5	0	11
OG0000196	2	4	3	2	11
OG0000197	2	3	4	2	11
OG0000198	4	3	2	2	11
OG0000199	11	0	0	0	11
OG0000200	1	6	4	0	11
OG0000201	5	4	1	1	11
OG0000202	3	4	4	0	11
OG0000203	1	6	4	0	11
OG0000204	2	8	1	0	11
OG0000205	1	0	9	1	11
OG0000206	5	2	4	0	11
OG0000207	1	2	8	0	11
OG0000208	11	0	0	0	11
OG0000209	0	11	0	0	11
OG0000210	0	11	0	0	11
OG0000211	0	11	0	0	11
OG0000212	0	3	7	1	11
OG0000213	0	11	0	0	11
OG0000214	0	11	0	0	11
OG0000215	0	11	0	0	11
OG0000216	0	11	0	0	11
OG0000217	0	11	0	0	11
OG0000218	0	11	0	0	11
OG0000219	0	0	11	0	11
OG0000220	0	0	11	0	11
OG0000221	1	5	2	2	10
OG0000222	10	0	0	0	10
OG0000223	5	3	0	2	10
OG0000224	4	2	2	2	10
OG0000225	2	7	0	1	10
OG0000226	2	2	4	2	10
OG0000227	1	8	1	0	10
OG0000228	6	2	1	1	10
OG0000229	8	2	0	0	10
OG0000230	2	4	2	2	10
OG0000231	2	3	4	1	10
OG0000232	1	4	4	1	10
OG0000233	2	5	2	1	10
OG0000234	2	2	4	2	10
OG0000235	3	2	4	1	10
OG0000236	10	0	0	0	10
OG0000237	10	0	0	0	10
OG0000238	7	1	1	1	10
OG0000239	1	4	4	1	10
OG0000240	7	1	2	0	10
OG0000241	1	1	6	2	10
OG0000242	2	5	3	0	10
OG0000243	4	3	2	1	10
OG0000244	3	3	1	3	10
OG0000245	3	1	6	0	10
OG0000246	2	5	3	0	10
OG0000247	6	3	0	1	10
OG0000248	2	5	2	1	10
OG0000249	6	2	2	0	10
OG0000250	1	6	2	1	10
OG0000251	2	3	3	2	10
OG0000252	4	2	3	1	10
OG0000253	1	7	1	1	10
OG0000254	2	4	3	1	10
OG0000255	1	7	0	2	10
OG0000256	1	2	5	2	10
OG0000257	1	6	2	1	10
OG0000258	1	6	1	2	10
OG0000259	10	0	0	0	10
OG0000260	1	7	2	0	10
OG0000261	1	4	3	2	10
OG0000262	0	1	9	0	10
OG0000263	0	10	0	0	10
OG0000264	0	10	0	0	10
OG0000265	0	9	1	0	10
OG0000266	0	10	0	0	10
OG0000267	0	3	6	1	10
OG0000268	0	10	0	0	10
OG0000269	0	10	0	0	10
OG0000270	0	10	0	0	10
OG0000271	0	10	0	0	10
OG0000272	0	10	0	0	10
OG0000273	0	2	6	2	10
OG0000274	0	10	0	0	10
OG0000275	0	0	10	0	10
OG0000276	0	0	10	0	10
OG0000277	9	0	0	0	9
OG0000278	1	0	8	0	9
OG0000279	1	5	1	2	9
OG0000280	2	5	2	0	9
OG0000281	2	3	3	1	9
OG0000282	3	4	1	1	9
OG0000283	1	1	4	3	9
OG0000284	9	0	0	0	9
OG0000285	2	3	1	3	9
OG0000286	2	2	3	2	9
OG0000287	1	4	4	0	9
OG0000288	1	7	1	0	9
OG0000289	2	3	2	2	9
OG0000290	4	2	2	1	9
OG0000291	3	3	1	2	9
OG0000292	3	2	2	2	9
OG0000293	9	0	0	0	9
OG0000294	2	3	2	2	9
OG0000295	1	3	4	1	9
OG0000296	9	0	0	0	9
OG0000297	2	3	3	1	9
OG0000298	2	2	2	3	9
OG0000299	1	3	3	2	9
OG0000300	9	0	0	0	9
OG0000301	2	3	3	1	9
OG0000302	5	2	2	0	9
OG0000303	1	4	3	1	9
OG0000304	9	0	0	0	9
OG0000305	1	4	2	2	9
OG0000306	1	6	2	0	9
OG0000307	1	2	5	1	9
OG0000308	2	4	2	1	9
OG0000309	1	6	1	1	9
OG0000310	9	0	0	0	9
OG0000311	4	3	0	2	9
OG0000312	3	3	2	1	9
OG0000313	9	0	0	0	9
OG0000314	2	5	1	1	9
OG0000315	2	0	4	3	9
OG0000316	3	0	6	0	9
OG0000317	7	1	1	0	9
OG0000318	9	0	0	0	9
OG0000319	2	3	2	2	9
OG0000320	3	5	0	1	9
OG0000321	4	1	2	2	9
OG0000322	2	4	2	1	9
OG0000323	2	4	3	0	9
OG0000324	2	2	3	2	9
OG0000325	1	7	0	1	9
OG0000326	1	4	4	0	9
OG0000327	1	2	5	1	9
OG0000328	1	6	1	1	9
OG0000329	1	0	0	8	9
OG0000330	9	0	0	0	9
OG0000331	0	9	0	0	9
OG0000332	0	9	0	0	9
OG0000333	0	9	0	0	9
OG0000334	0	7	0	2	9
OG0000335	0	9	0	0	9
OG0000336	0	9	0	0	9
OG0000337	0	9	0	0	9
OG0000338	0	0	7	2	9
OG0000339	0	0	9	0	9
OG0000340	0	0	9	0	9
OG0000341	0	0	9	0	9
OG0000342	0	0	0	9	9
OG0000343	3	2	3	0	8
OG0000344	4	1	1	2	8
OG0000345	3	1	2	2	8
OG0000346	8	0	0	0	8
OG0000347	3	2	1	2	8
OG0000348	1	5	1	1	8
OG0000349	3	2	2	1	8
OG0000350	1	1	1	5	8
OG0000351	2	4	2	0	8
OG0000352	3	2	2	1	8
OG0000353	8	0	0	0	8
OG0000354	3	1	4	0	8
OG0000355	3	4	1	0	8
OG0000356	2	1	3	2	8
OG0000357	2	2	2	2	8
OG0000358	1	1	6	0	8
OG0000359	2	4	2	0	8
OG0000360	6	1	1	0	8
OG0000361	1	3	2	2	8
OG0000362	2	1	4	1	8
OG0000363	2	2	1	3	8
OG0000364	3	3	2	0	8
OG0000365	2	2	2	2	8
OG0000366	2	3	1	2	8
OG0000367	2	2	2	2	8
OG0000368	2	3	2	1	8
OG0000369	2	2	2	2	8
OG0000370	1	1	6	0	8
OG0000371	1	1	5	1	8
OG0000372	8	0	0	0	8
OG0000373	2	2	2	2	8
OG0000374	1	2	4	1	8
OG0000375	7	1	0	0	8
OG0000376	1	3	2	2	8
OG0000377	3	2	1	2	8
OG0000378	1	4	2	1	8
OG0000379	1	4	2	1	8
OG0000380	6	1	1	0	8
OG0000381	1	3	2	2	8
OG0000382	2	2	2	2	8
OG0000383	1	3	1	3	8
OG0000384	1	1	2	4	8
OG0000385	1	1	5	1	8
OG0000386	1	5	2	0	8
OG0000387	8	0	0	0	8
OG0000388	1	3	1	3	8
OG0000389	2	3	2	1	8
OG0000390	1	3	3	1	8
OG0000391	4	1	3	0	8
OG0000392	2	3	3	0	8
OG0000393	2	4	1	1	8
OG0000394	2	3	2	1	8
OG0000395	2	1	4	1	8
OG0000396	1	3	4	0	8
OG0000397	1	3	1	3	8
OG0000398	1	2	4	1	8
OG0000399	1	2	3	2	8
OG0000400	1	4	2	1	8
OG0000401	4	2	2	0	8
OG0000402	2	3	1	2	8
OG0000403	2	2	1	3	8
OG0000404	5	1	1	1	8
OG0000405	2	3	2	1	8
OG0000406	2	4	2	0	8
OG0000407	1	2	4	1	8
OG0000408	1	6	0	1	8
OG0000409	1	5	1	1	8
OG0000410	0	8	0	0	8
OG0000411	0	8	0	0	8
OG0000412	0	8	0	0	8
OG0000413	0	5	3	0	8
OG0000414	0	7	1	0	8
OG0000415	0	4	3	1	8
OG0000416	0	8	0	0	8
OG0000417	0	7	1	0	8
OG0000418	0	8	0	0	8
OG0000419	0	8	0	0	8
OG0000420	0	8	0	0	8
OG0000421	0	8	0	0	8
OG0000422	0	8	0	0	8
OG0000423	0	0	8	0	8
OG0000424	0	0	8	0	8
OG0000425	0	0	8	0	8
OG0000426	0	0	8	0	8
OG0000427	0	0	8	0	8
OG0000428	0	0	8	0	8
OG0000429	0	0	8	0	8
OG0000430	0	0	0	8	8
OG0000431	0	0	0	8	8
OG0000432	2	1	3	1	7
OG0000433	4	2	1	0	7
OG0000434	2	2	2	1	7
OG0000435	1	6	0	0	7
OG0000436	7	0	0	0	7
OG0000437	2	0	3	2	7
OG0000438	2	2	3	0	7
OG0000439	2	3	1	1	7
OG0000440	1	4	1	1	7
OG0000441	2	4	1	0	7
OG0000442	1	2	2	2	7
OG0000443	1	1	2	3	7
OG0000444	2	2	2	1	7
OG0000445	2	1	3	1	7
OG0000446	1	3	2	1	7
OG0000447	1	3	2	1	7
OG0000448	2	1	4	0	7
OG0000449	1	3	2	1	7
OG0000450	1	1	4	1	7
OG0000451	2	2	2	1	7
OG0000452	7	0	0	0	7
OG0000453	2	3	2	0	7
OG0000454	1	2	2	2	7
OG0000455	5	1	1	0	7
OG0000456	2	2	2	1	7
OG0000457	2	2	2	1	7
OG0000458	1	2	2	2	7
OG0000459	2	1	3	1	7
OG0000460	2	2	3	0	7
OG0000461	3	2	1	1	7
OG0000462	1	2	2	2	7
OG0000463	2	4	1	0	7
OG0000464	2	3	1	1	7
OG0000465	3	1	2	1	7
OG0000466	1	4	1	1	7
OG0000467	2	2	2	1	7
OG0000468	7	0	0	0	7
OG0000469	7	0	0	0	7
OG0000470	1	3	2	1	7
OG0000471	2	1	3	1	7
OG0000472	2	2	3	0	7
OG0000473	1	5	1	0	7
OG0000474	1	4	1	1	7
OG0000475	5	1	1	0	7
OG0000476	3	1	2	1	7
OG0000477	2	3	1	1	7
OG0000478	7	0	0	0	7
OG0000479	2	1	2	2	7
OG0000480	1	3	2	1	7
OG0000481	1	1	4	1	7
OG0000482	1	2	3	1	7
OG0000483	3	2	2	0	7
OG0000484	2	2	2	1	7
OG0000485	3	2	1	1	7
OG0000486	2	1	4	0	7
OG0000487	3	1	1	2	7
OG0000488	1	3	2	1	7
OG0000489	1	2	4	0	7
OG0000490	1	4	1	1	7
OG0000491	1	1	5	0	7
OG0000492	2	2	2	1	7
OG0000493	4	1	2	0	7
OG0000494	2	3	1	1	7
OG0000495	1	2	3	1	7
OG0000496	1	3	1	2	7
OG0000497	2	2	3	0	7
OG0000498	3	1	2	1	7
OG0000499	1	2	3	1	7
OG0000500	2	2	1	2	7
OG0000501	1	2	2	2	7
OG0000502	2	2	2	1	7
OG0000503	2	3	1	1	7
OG0000504	3	1	2	1	7
OG0000505	2	2	2	1	7
OG0000506	1	2	2	2	7
OG0000507	2	3	2	0	7
OG0000508	3	2	2	0	7
OG0000509	1	4	1	1	7
OG0000510	2	3	1	1	7
OG0000511	1	2	4	0	7
OG0000512	1	1	4	1	7
OG0000513	2	2	2	1	7
OG0000514	3	2	1	1	7
OG0000515	1	2	2	2	7
OG0000516	7	0	0	0	7
OG0000517	1	3	3	0	7
OG0000518	1	3	1	2	7
OG0000519	1	2	2	2	7
OG0000520	1	5	1	0	7
OG0000521	3	1	2	1	7
OG0000522	1	5	1	0	7
OG0000523	2	2	2	1	7
OG0000524	1	3	3	0	7
OG0000525	1	2	1	3	7
OG0000526	3	1	3	0	7
OG0000527	1	2	3	1	7
OG0000528	2	2	3	0	7
OG0000529	2	1	3	1	7
OG0000530	3	1	2	1	7
OG0000531	5	1	1	0	7
OG0000532	2	2	2	1	7
OG0000533	2	2	2	1	7
OG0000534	1	5	1	0	7
OG0000535	1	4	1	1	7
OG0000536	2	4	1	0	7
OG0000537	1	1	4	1	7
OG0000538	3	1	1	2	7
OG0000539	2	2	2	1	7
OG0000540	1	3	2	1	7
OG0000541	1	2	3	1	7
OG0000542	1	3	2	1	7
OG0000543	1	4	2	0	7
OG0000544	1	3	1	2	7
OG0000545	2	3	2	0	7
OG0000546	2	4	1	0	7
OG0000547	2	4	1	0	7
OG0000548	2	3	2	0	7
OG0000549	2	2	3	0	7
OG0000550	2	3	1	1	7
OG0000551	2	2	2	1	7
OG0000552	1	2	3	1	7
OG0000553	1	3	2	1	7
OG0000554	1	4	1	1	7
OG0000555	2	2	3	0	7
OG0000556	2	3	1	1	7
OG0000557	3	1	3	0	7
OG0000558	1	3	3	0	7
OG0000559	2	1	2	2	7
OG0000560	1	5	1	0	7
OG0000561	3	1	2	1	7
OG0000562	1	3	2	1	7
OG0000563	2	2	1	2	7
OG0000564	1	1	5	0	7
OG0000565	1	5	1	0	7
OG0000566	1	1	4	1	7
OG0000567	1	2	1	3	7
OG0000568	1	2	2	2	7
OG0000569	1	1	3	2	7
OG0000570	1	3	1	2	7
OG0000571	1	4	2	0	7
OG0000572	1	2	2	2	7
OG0000573	2	2	3	0	7
OG0000574	2	2	2	1	7
OG0000575	2	3	1	1	7
OG0000576	2	2	1	2	7
OG0000577	1	1	2	3	7
OG0000578	1	1	1	4	7
OG0000579	1	1	1	4	7
OG0000580	0	3	0	4	7
OG0000581	0	2	5	0	7
OG0000582	0	3	4	0	7
OG0000583	0	6	1	0	7
OG0000584	0	1	6	0	7
OG0000585	0	6	0	1	7
OG0000586	0	7	0	0	7
OG0000587	0	2	3	2	7
OG0000588	0	7	0	0	7
OG0000589	0	7	0	0	7
OG0000590	0	6	1	0	7
OG0000591	0	7	0	0	7
OG0000592	0	6	1	0	7
OG0000593	0	7	0	0	7
OG0000594	0	7	0	0	7
OG0000595	0	7	0	0	7
OG0000596	0	7	0	0	7
OG0000597	0	3	4	0	7
OG0000598	0	7	0	0	7
OG0000599	0	1	6	0	7
OG0000600	0	2	5	0	7
OG0000601	0	7	0	0	7
OG0000602	0	7	0	0	7
OG0000603	0	7	0	0	7
OG0000604	0	2	5	0	7
OG0000605	0	7	0	0	7
OG0000606	0	6	1	0	7
OG0000607	0	1	6	0	7
OG0000608	0	2	4	1	7
OG0000609	0	7	0	0	7
OG0000610	0	3	2	2	7
OG0000611	0	0	7	0	7
OG0000612	0	0	7	0	7
OG0000613	0	0	7	0	7
OG0000614	0	0	7	0	7
OG0000615	0	0	7	0	7
OG0000616	0	0	7	0	7
OG0000617	0	0	7	0	7
OG0000618	0	0	0	7	7
OG0000619	0	0	0	7	7
OG0000620	0	0	0	7	7
OG0000621	0	0	0	7	7
OG0000622	0	0	0	7	7
OG0000623	3	2	1	0	6
OG0000624	1	2	1	2	6
OG0000625	2	2	1	1	6
OG0000626	3	2	1	0	6
OG0000627	2	2	2	0	6
OG0000628	1	1	2	2	6
OG0000629	1	1	1	3	6
OG0000630	2	2	2	0	6
OG0000631	1	3	1	1	6
OG0000632	1	3	2	0	6
OG0000633	3	2	1	0	6
OG0000634	4	0	2	0	6
OG0000635	2	2	1	1	6
OG0000636	2	1	1	2	6
OG0000637	1	1	2	2	6
OG0000638	2	1	2	1	6
OG0000639	1	4	1	0	6
OG0000640	1	3	1	1	6
OG0000641	2	2	2	0	6
OG0000642	6	0	0	0	6
OG0000643	1	1	4	0	6
OG0000644	3	2	1	0	6
OG0000645	1	2	1	2	6
OG0000646	2	1	2	1	6
OG0000647	2	1	2	1	6
OG0000648	1	2	2	1	6
OG0000649	1	3	1	1	6
OG0000650	1	2	2	1	6
OG0000651	1	1	2	2	6
OG0000652	6	0	0	0	6
OG0000653	2	1	2	1	6
OG0000654	3	1	2	0	6
OG0000655	1	3	1	1	6
OG0000656	2	1	1	2	6
OG0000657	5	1	0	0	6
OG0000658	2	1	2	1	6
OG0000659	2	2	2	0	6
OG0000660	1	1	3	1	6
OG0000661	1	1	3	1	6
OG0000662	1	2	2	1	6
OG0000663	2	1	1	2	6
OG0000664	1	3	2	0	6
OG0000665	1	2	1	2	6
OG0000666	1	1	3	1	6
OG0000667	1	2	2	1	6
OG0000668	5	1	0	0	6
OG0000669	2	1	2	1	6
OG0000670	1	3	1	1	6
OG0000671	2	3	1	0	6
OG0000672	6	0	0	0	6
OG0000673	1	1	2	2	6
OG0000674	1	5	0	0	6
OG0000675	1	2	2	1	6
OG0000676	1	2	1	2	6
OG0000677	2	1	1	2	6
OG0000678	1	2	2	1	6
OG0000679	1	2	3	0	6
OG0000680	1	1	3	1	6
OG0000681	1	3	1	1	6
OG0000682	1	1	1	3	6
OG0000683	1	1	3	1	6
OG0000684	4	1	1	0	6
OG0000685	1	2	2	1	6
OG0000686	2	2	2	0	6
OG0000687	2	3	0	1	6
OG0000688	1	2	1	2	6
OG0000689	1	2	1	2	6
OG0000690	3	1	2	0	6
OG0000691	1	2	2	1	6
OG0000692	2	3	1	0	6
OG0000693	1	1	2	2	6
OG0000694	1	2	3	0	6
OG0000695	1	1	3	1	6
OG0000696	3	1	1	1	6
OG0000697	2	1	2	1	6
OG0000698	2	2	1	1	6
OG0000699	1	2	3	0	6
OG0000700	1	1	1	3	6
OG0000701	1	1	2	2	6
OG0000702	1	2	1	2	6
OG0000703	3	1	1	1	6
OG0000704	1	3	1	1	6
OG0000705	2	2	1	1	6
OG0000706	1	2	2	1	6
OG0000707	1	2	2	1	6
OG0000708	1	1	2	2	6
OG0000709	2	3	1	0	6
OG0000710	3	1	1	1	6
OG0000711	2	2	1	1	6
OG0000712	1	2	2	1	6
OG0000713	2	2	1	1	6
OG0000714	3	1	1	1	6
OG0000715	1	2	2	1	6
OG0000716	1	2	2	1	6
OG0000717	1	2	0	3	6
OG0000718	1	2	2	1	6
OG0000719	2	1	2	1	6
OG0000720	6	0	0	0	6
OG0000721	1	1	3	1	6
OG0000722	2	1	2	1	6
OG0000723	2	1	2	1	6
OG0000724	2	2	1	1	6
OG0000725	1	1	3	1	6
OG0000726	2	1	1	2	6
OG0000727	3	1	1	1	6
OG0000728	1	3	1	1	6
OG0000729	1	3	1	1	6
OG0000730	6	0	0	0	6
OG0000731	1	3	2	0	6
OG0000732	2	1	3	0	6
OG0000733	1	3	0	2	6
OG0000734	1	2	1	2	6
OG0000735	1	1	1	3	6
OG0000736	2	1	3	0	6
OG0000737	1	2	2	1	6
OG0000738	1	1	1	3	6
OG0000739	2	3	1	0	6
OG0000740	1	3	2	0	6
OG0000741	2	1	2	1	6
OG0000742	1	5	0	0	6
OG0000743	1	1	3	1	6
OG0000744	1	1	2	2	6
OG0000745	1	1	3	1	6
OG0000746	1	3	1	1	6
OG0000747	3	1	2	0	6
OG0000748	3	1	2	0	6
OG0000749	1	3	1	1	6
OG0000750	3	1	2	0	6
OG0000751	1	2	3	0	6
OG0000752	1	2	1	2	6
OG0000753	1	1	2	2	6
OG0000754	2	2	1	1	6
OG0000755	2	1	1	2	6
OG0000756	1	1	3	1	6
OG0000757	2	3	1	0	6
OG0000758	6	0	0	0	6
OG0000759	2	1	1	2	6
OG0000760	1	2	2	1	6
OG0000761	4	1	1	0	6
OG0000762	5	1	0	0	6
OG0000763	6	0	0	0	6
OG0000764	6	0	0	0	6
OG0000765	1	2	2	1	6
OG0000766	1	4	1	0	6
OG0000767	2	2	2	0	6
OG0000768	1	2	1	2	6
OG0000769	1	2	2	1	6
OG0000770	2	2	2	0	6
OG0000771	4	1	1	0	6
OG0000772	2	2	2	0	6
OG0000773	1	1	4	0	6
OG0000774	2	2	1	1	6
OG0000775	1	3	1	1	6
OG0000776	1	3	2	0	6
OG0000777	1	1	2	2	6
OG0000778	2	2	2	0	6
OG0000779	3	2	1	0	6
OG0000780	3	2	1	0	6
OG0000781	6	0	0	0	6
OG0000782	2	2	1	1	6
OG0000783	1	1	3	1	6
OG0000784	1	1	2	2	6
OG0000785	1	5	0	0	6
OG0000786	1	2	1	2	6
OG0000787	3	1	2	0	6
OG0000788	1	3	2	0	6
OG0000789	1	3	2	0	6
OG0000790	1	3	1	1	6
OG0000791	1	2	2	1	6
OG0000792	6	0	0	0	6
OG0000793	1	2	2	1	6
OG0000794	1	4	1	0	6
OG0000795	2	2	2	0	6
OG0000796	1	1	3	1	6
OG0000797	1	3	2	0	6
OG0000798	3	1	1	1	6
OG0000799	2	1	2	1	6
OG0000800	1	2	2	1	6
OG0000801	1	2	1	2	6
OG0000802	1	1	3	1	6
OG0000803	3	1	1	1	6
OG0000804	2	2	2	0	6
OG0000805	1	2	2	1	6
OG0000806	1	4	1	0	6
OG0000807	1	2	3	0	6
OG0000808	2	1	2	1	6
OG0000809	1	1	2	2	6
OG0000810	1	4	1	0	6
OG0000811	1	4	0	1	6
OG0000812	1	1	3	1	6
OG0000813	1	2	1	2	6
OG0000814	1	1	3	1	6
OG0000815	1	3	1	1	6
OG0000816	1	2	2	1	6
OG0000817	2	2	1	1	6
OG0000818	1	2	2	1	6
OG0000819	2	2	1	1	6
OG0000820	1	3	1	1	6
OG0000821	1	2	2	1	6
OG0000822	1	4	1	0	6
OG0000823	1	2	1	2	6
OG0000824	1	1	4	0	6
OG0000825	3	1	1	1	6
OG0000826	1	1	2	2	6
OG0000827	1	3	2	0	6
OG0000828	1	1	3	1	6
OG0000829	2	1	1	2	6
OG0000830	1	2	2	1	6
OG0000831	2	2	1	1	6
OG0000832	1	3	2	0	6
OG0000833	1	2	1	2	6
OG0000834	1	3	2	0	6
OG0000835	2	1	2	1	6
OG0000836	1	2	2	1	6
OG0000837	1	2	1	2	6
OG0000838	1	2	2	1	6
OG0000839	1	3	2	0	6
OG0000840	1	1	4	0	6
OG0000841	1	3	2	0	6
OG0000842	2	2	2	0	6
OG0000843	1	1	1	3	6
OG0000844	1	1	3	1	6
OG0000845	2	1	3	0	6
OG0000846	1	2	1	2	6
OG0000847	1	4	1	0	6
OG0000848	1	5	0	0	6
OG0000849	1	3	1	1	6
OG0000850	1	3	1	1	6
OG0000851	1	2	1	2	6
OG0000852	1	2	2	1	6
OG0000853	3	1	2	0	6
OG0000854	2	1	1	2	6
OG0000855	1	1	4	0	6
OG0000856	1	2	1	2	6
OG0000857	1	1	2	2	6
OG0000858	1	3	2	0	6
OG0000859	1	2	1	2	6
OG0000860	1	1	3	1	6
OG0000861	1	3	1	1	6
OG0000862	1	1	4	0	6
OG0000863	1	2	2	1	6
OG0000864	1	4	1	0	6
OG0000865	1	3	1	1	6
OG0000866	6	0	0	0	6
OG0000867	1	1	2	2	6
OG0000868	1	1	2	2	6
OG0000869	1	2	3	0	6
OG0000870	1	1	2	2	6
OG0000871	1	1	3	1	6
OG0000872	0	6	0	0	6
OG0000873	0	3	2	1	6
OG0000874	0	3	2	1	6
OG0000875	0	6	0	0	6
OG0000876	0	5	0	1	6
OG0000877	0	6	0	0	6
OG0000878	0	6	0	0	6
OG0000879	0	6	0	0	6
OG0000880	0	6	0	0	6
OG0000881	0	2	3	1	6
OG0000882	0	6	0	0	6
OG0000883	0	6	0	0	6
OG0000884	0	6	0	0	6
OG0000885	0	6	0	0	6
OG0000886	0	6	0	0	6
OG0000887	0	6	0	0	6
OG0000888	0	1	5	0	6
OG0000889	0	3	3	0	6
OG0000890	0	6	0	0	6
OG0000891	0	5	1	0	6
OG0000892	0	6	0	0	6
OG0000893	0	6	0	0	6
OG0000894	0	2	4	0	6
OG0000895	0	1	5	0	6
OG0000896	0	3	1	2	6
OG0000897	0	2	2	2	6
OG0000898	0	6	0	0	6
OG0000899	0	6	0	0	6
OG0000900	0	6	0	0	6
OG0000901	0	5	1	0	6
OG0000902	0	2	4	0	6
OG0000903	0	6	0	0	6
OG0000904	0	6	0	0	6
OG0000905	0	6	0	0	6
OG0000906	0	6	0	0	6
OG0000907	0	1	5	0	6
OG0000908	0	1	5	0	6
OG0000909	0	5	1	0	6
OG0000910	0	6	0	0	6
OG0000911	0	6	0	0	6
OG0000912	0	2	3	1	6
OG0000913	0	1	5	0	6
OG0000914	0	1	5	0	6
OG0000915	0	1	5	0	6
OG0000916	0	6	0	0	6
OG0000917	0	0	6	0	6
OG0000918	0	0	6	0	6
OG0000919	0	0	6	0	6
OG0000920	0	0	6	0	6
OG0000921	0	0	6	0	6
OG0000922	0	0	6	0	6
OG0000923	0	0	6	0	6
OG0000924	0	0	2	4	6
OG0000925	0	0	6	0	6
OG0000926	0	0	0	6	6
OG0000927	0	0	0	6	6
OG0000928	5	0	0	0	5
OG0000929	1	1	2	1	5
OG0000930	1	1	2	1	5
OG0000931	5	0	0	0	5
OG0000932	2	1	1	1	5
OG0000933	1	1	1	2	5
OG0000934	2	1	1	1	5
OG0000935	2	2	1	0	5
OG0000936	1	2	1	1	5
OG0000937	2	1	1	1	5
OG0000938	1	2	1	1	5
OG0000939	1	1	3	0	5
OG0000940	1	2	1	1	5
OG0000941	1	1	2	1	5
OG0000942	1	1	2	1	5
OG0000943	1	2	2	0	5
OG0000944	1	2	1	1	5
OG0000945	1	1	1	2	5
OG0000946	2	2	1	0	5
OG0000947	1	1	1	2	5
OG0000948	1	1	2	1	5
OG0000949	1	2	1	1	5
OG0000950	1	2	1	1	5
OG0000951	1	1	2	1	5
OG0000952	1	1	1	2	5
OG0000953	1	1	2	1	5
OG0000954	2	1	2	0	5
OG0000955	1	1	1	2	5
OG0000956	1	1	1	2	5
OG0000957	1	2	1	1	5
OG0000958	2	1	1	1	5
OG0000959	2	1	1	1	5
OG0000960	1	3	1	0	5
OG0000961	1	3	1	0	5
OG0000962	1	1	1	2	5
OG0000963	1	1	2	1	5
OG0000964	1	1	1	2	5
OG0000965	2	2	1	0	5
OG0000966	2	2	1	0	5
OG0000967	2	1	2	0	5
OG0000968	3	1	1	0	5
OG0000969	1	2	2	0	5
OG0000970	5	0	0	0	5
OG0000971	5	0	0	0	5
OG0000972	1	1	1	2	5
OG0000973	2	2	1	0	5
OG0000974	3	0	2	0	5
OG0000975	1	1	1	2	5
OG0000976	3	1	1	0	5
OG0000977	2	1	1	1	5
OG0000978	1	1	2	1	5
OG0000979	1	2	1	1	5
OG0000980	1	1	1	2	5
OG0000981	1	2	1	1	5
OG0000982	2	1	1	1	5
OG0000983	2	1	2	0	5
OG0000984	1	2	1	1	5
OG0000985	1	1	2	1	5
OG0000986	1	2	1	1	5
OG0000987	1	1	2	1	5
OG0000988	1	2	1	1	5
OG0000989	5	0	0	0	5
OG0000990	2	1	1	1	5
OG0000991	2	1	2	0	5
OG0000992	1	1	1	2	5
OG0000993	1	2	2	0	5
OG0000994	1	1	2	1	5
OG0000995	2	1	2	0	5
OG0000996	1	1	2	1	5
OG0000997	2	2	1	0	5
OG0000998	1	1	1	2	5
OG0000999	1	2	1	1	5
OG0001000	1	1	1	2	5
OG0001001	2	2	1	0	5
OG0001002	2	1	2	0	5
OG0001003	1	1	2	1	5
OG0001004	2	1	2	0	5
OG0001005	1	1	2	1	5
OG0001006	2	1	1	1	5
OG0001007	1	1	1	2	5
OG0001008	2	1	1	1	5
OG0001009	1	2	1	1	5
OG0001010	2	1	1	1	5
OG0001011	2	1	2	0	5
OG0001012	1	1	2	1	5
OG0001013	2	1	1	1	5
OG0001014	2	1	1	1	5
OG0001015	1	1	2	1	5
OG0001016	1	1	2	1	5
OG0001017	1	2	1	1	5
OG0001018	1	2	1	1	5
OG0001019	1	1	1	2	5
OG0001020	1	1	3	0	5
OG0001021	1	2	1	1	5
OG0001022	1	1	1	2	5
OG0001023	1	1	2	1	5
OG0001024	1	1	2	1	5
OG0001025	2	1	1	1	5
OG0001026	1	2	1	1	5
OG0001027	3	1	1	0	5
OG0001028	1	2	1	1	5
OG0001029	1	1	2	1	5
OG0001030	2	1	1	1	5
OG0001031	1	2	1	1	5
OG0001032	1	1	1	2	5
OG0001033	1	2	1	1	5
OG0001034	1	1	2	1	5
OG0001035	1	1	1	2	5
OG0001036	1	2	1	1	5
OG0001037	1	1	3	0	5
OG0001038	1	1	1	2	5
OG0001039	1	1	3	0	5
OG0001040	3	1	1	0	5
OG0001041	1	1	2	1	5
OG0001042	2	1	1	1	5
OG0001043	1	1	3	0	5
OG0001044	1	1	2	1	5
OG0001045	1	1	2	1	5
OG0001046	2	1	1	1	5
OG0001047	1	1	1	2	5
OG0001048	2	1	2	0	5
OG0001049	1	1	1	2	5
OG0001050	3	1	1	0	5
OG0001051	1	2	1	1	5
OG0001052	1	1	1	2	5
OG0001053	2	2	1	0	5
OG0001054	1	1	1	2	5
OG0001055	1	1	2	1	5
OG0001056	5	0	0	0	5
OG0001057	1	2	1	1	5
OG0001058	1	1	2	1	5
OG0001059	1	2	1	1	5
OG0001060	1	1	2	1	5
OG0001061	1	1	2	1	5
OG0001062	1	2	2	0	5
OG0001063	1	1	3	0	5
OG0001064	1	1	2	1	5
OG0001065	1	1	2	1	5
OG0001066	3	1	1	0	5
OG0001067	1	1	1	2	5
OG0001068	1	1	2	1	5
OG0001069	5	0	0	0	5
OG0001070	2	1	1	1	5
OG0001071	1	2	1	1	5
OG0001072	4	1	0	0	5
OG0001073	5	0	0	0	5
OG0001074	2	1	1	1	5
OG0001075	1	2	1	1	5
OG0001076	2	2	1	0	5
OG0001077	2	1	1	1	5
OG0001078	1	2	1	1	5
OG0001079	2	1	1	1	5
OG0001080	2	1	2	0	5
OG0001081	1	1	1	2	5
OG0001082	2	1	1	1	5
OG0001083	1	1	2	1	5
OG0001084	2	1	1	1	5
OG0001085	1	1	1	2	5
OG0001086	2	1	1	1	5
OG0001087	2	1	1	1	5
OG0001088	1	1	1	2	5
OG0001089	5	0	0	0	5
OG0001090	2	2	1	0	5
OG0001091	2	1	1	1	5
OG0001092	1	1	2	1	5
OG0001093	1	2	1	1	5
OG0001094	1	2	1	1	5
OG0001095	2	2	1	0	5
OG0001096	1	1	2	1	5
OG0001097	2	1	1	1	5
OG0001098	1	3	1	0	5
OG0001099	1	1	2	1	5
OG0001100	1	1	2	1	5
OG0001101	1	1	1	2	5
OG0001102	1	1	2	1	5
OG0001103	1	1	2	1	5
OG0001104	1	1	2	1	5
OG0001105	5	0	0	0	5
OG0001106	1	1	2	1	5
OG0001107	1	3	1	0	5
OG0001108	1	1	1	2	5
OG0001109	1	1	1	2	5
OG0001110	1	2	1	1	5
OG0001111	1	1	2	1	5
OG0001112	3	1	1	0	5
OG0001113	1	1	2	1	5
OG0001114	1	1	2	1	5
OG0001115	1	1	1	2	5
OG0001116	1	3	1	0	5
OG0001117	1	2	1	1	5
OG0001118	2	1	1	1	5
OG0001119	5	0	0	0	5
OG0001120	1	1	3	0	5
OG0001121	1	2	1	1	5
OG0001122	1	2	1	1	5
OG0001123	1	2	1	1	5
OG0001124	1	2	2	0	5
OG0001125	1	1	1	2	5
OG0001126	3	1	1	0	5
OG0001127	1	2	1	1	5
OG0001128	1	1	1	2	5
OG0001129	1	1	2	1	5
OG0001130	1	1	2	1	5
OG0001131	1	1	1	2	5
OG0001132	1	1	1	2	5
OG0001133	1	1	2	1	5
OG0001134	1	2	1	1	5
OG0001135	1	1	2	1	5
OG0001136	1	1	3	0	5
OG0001137	2	1	1	1	5
OG0001138	2	1	1	1	5
OG0001139	1	1	2	1	5
OG0001140	1	2	1	1	5
OG0001141	1	1	2	1	5
OG0001142	1	1	1	2	5
OG0001143	1	2	1	1	5
OG0001144	1	1	2	1	5
OG0001145	1	2	1	1	5
OG0001146	1	2	1	1	5
OG0001147	1	1	1	2	5
OG0001148	2	1	1	1	5
OG0001149	2	1	1	1	5
OG0001150	2	1	1	1	5
OG0001151	1	1	2	1	5
OG0001152	1	2	1	1	5
OG0001153	1	1	1	2	5
OG0001154	1	1	1	2	5
OG0001155	1	1	1	2	5
OG0001156	3	1	1	0	5
OG0001157	1	1	1	2	5
OG0001158	2	1	1	1	5
OG0001159	1	1	1	2	5
OG0001160	1	1	2	1	5
OG0001161	1	2	1	1	5
OG0001162	1	1	2	1	5
OG0001163	2	1	1	1	5
OG0001164	1	1	1	2	5
OG0001165	1	2	2	0	5
OG0001166	1	2	1	1	5
OG0001167	2	2	1	0	5
OG0001168	1	1	1	2	5
OG0001169	1	1	2	1	5
OG0001170	1	2	1	1	5
OG0001171	1	1	2	1	5
OG0001172	2	1	1	1	5
OG0001173	2	1	1	1	5
OG0001174	1	2	1	1	5
OG0001175	1	1	2	1	5
OG0001176	1	2	1	1	5
OG0001177	1	2	1	1	5
OG0001178	1	2	1	1	5
OG0001179	1	1	1	2	5
OG0001180	1	4	0	0	5
OG0001181	1	1	1	2	5
OG0001182	1	2	1	1	5
OG0001183	1	2	1	1	5
OG0001184	1	1	1	2	5
OG0001185	2	1	1	1	5
OG0001186	1	2	1	1	5
OG0001187	1	1	1	2	5
OG0001188	1	2	1	1	5
OG0001189	1	2	2	0	5
OG0001190	1	1	2	1	5
OG0001191	1	2	1	1	5
OG0001192	1	0	2	2	5
OG0001193	2	1	2	0	5
OG0001194	2	2	1	0	5
OG0001195	1	2	1	1	5
OG0001196	1	2	1	1	5
OG0001197	1	1	3	0	5
OG0001198	1	2	1	1	5
OG0001199	1	3	1	0	5
OG0001200	2	1	1	1	5
OG0001201	1	1	2	1	5
OG0001202	1	1	1	2	5
OG0001203	1	2	1	1	5
OG0001204	1	1	2	1	5
OG0001205	2	1	1	1	5
OG0001206	1	1	1	2	5
OG0001207	1	1	2	1	5
OG0001208	1	1	2	1	5
OG0001209	1	1	1	2	5
OG0001210	1	1	2	1	5
OG0001211	1	1	1	2	5
OG0001212	3	1	1	0	5
OG0001213	1	1	2	1	5
OG0001214	1	3	1	0	5
OG0001215	3	1	1	0	5
OG0001216	1	2	1	1	5
OG0001217	2	1	2	0	5
OG0001218	1	1	1	2	5
OG0001219	1	2	2	0	5
OG0001220	5	0	0	0	5
OG0001221	4	0	0	1	5
OG0001222	5	0	0	0	5
OG0001223	2	1	1	1	5
OG0001224	1	2	1	1	5
OG0001225	1	1	2	1	5
OG0001226	1	2	1	1	5
OG0001227	1	1	3	0	5
OG0001228	1	1	1	2	5
OG0001229	1	2	1	1	5
OG0001230	5	0	0	0	5
OG0001231	1	2	1	1	5
OG0001232	1	1	1	2	5
OG0001233	1	1	2	1	5
OG0001234	1	2	1	1	5
OG0001235	3	0	2	0	5
OG0001236	5	0	0	0	5
OG0001237	1	2	2	0	5
OG0001238	1	3	1	0	5
OG0001239	1	3	1	0	5
OG0001240	1	2	2	0	5
OG0001241	1	1	2	1	5
OG0001242	1	2	2	0	5
OG0001243	1	2	2	0	5
OG0001244	1	1	3	0	5
OG0001245	1	2	1	1	5
OG0001246	1	1	1	2	5
OG0001247	1	2	1	1	5
OG0001248	1	3	1	0	5
OG0001249	1	2	2	0	5
OG0001250	2	2	1	0	5
OG0001251	2	1	1	1	5
OG0001252	1	3	1	0	5
OG0001253	1	2	1	1	5
OG0001254	2	1	2	0	5
OG0001255	1	1	2	1	5
OG0001256	1	2	1	1	5
OG0001257	1	1	2	1	5
OG0001258	1	1	2	1	5
OG0001259	2	1	1	1	5
OG0001260	1	1	3	0	5
OG0001261	1	2	1	1	5
OG0001262	2	2	1	0	5
OG0001263	2	2	1	0	5
OG0001264	1	1	3	0	5
OG0001265	1	2	1	1	5
OG0001266	2	1	1	1	5
OG0001267	1	2	1	1	5
OG0001268	1	1	3	0	5
OG0001269	1	1	1	2	5
OG0001270	2	1	1	1	5
OG0001271	3	0	1	1	5
OG0001272	2	2	1	0	5
OG0001273	2	2	1	0	5
OG0001274	1	1	2	1	5
OG0001275	2	2	1	0	5
OG0001276	1	1	2	1	5
OG0001277	1	2	2	0	5
OG0001278	3	1	1	0	5
OG0001279	1	1	3	0	5
OG0001280	1	1	1	2	5
OG0001281	1	1	1	2	5
OG0001282	1	2	1	1	5
OG0001283	1	2	2	0	5
OG0001284	2	1	2	0	5
OG0001285	2	1	2	0	5
OG0001286	1	1	3	0	5
OG0001287	1	3	1	0	5
OG0001288	1	3	1	0	5
OG0001289	1	2	1	1	5
OG0001290	2	2	1	0	5
OG0001291	2	1	1	1	5
OG0001292	2	1	1	1	5
OG0001293	1	3	1	0	5
OG0001294	1	1	2	1	5
OG0001295	1	3	1	0	5
OG0001296	4	0	1	0	5
OG0001297	2	2	1	0	5
OG0001298	1	3	1	0	5
OG0001299	1	1	2	1	5
OG0001300	1	1	1	2	5
OG0001301	1	3	1	0	5
OG0001302	2	1	1	1	5
OG0001303	1	2	1	1	5
OG0001304	1	1	2	1	5
OG0001305	1	2	2	0	5
OG0001306	1	2	1	1	5
OG0001307	1	3	1	0	5
OG0001308	1	1	2	1	5
OG0001309	1	2	2	0	5
OG0001310	1	2	1	1	5
OG0001311	1	1	1	2	5
OG0001312	2	2	1	0	5
OG0001313	2	1	2	0	5
OG0001314	1	1	3	0	5
OG0001315	1	2	2	0	5
OG0001316	1	3	1	0	5
OG0001317	1	1	1	2	5
OG0001318	1	2	1	1	5
OG0001319	1	2	1	1	5
OG0001320	1	3	1	0	5
OG0001321	2	1	1	1	5
OG0001322	1	1	3	0	5
OG0001323	1	2	1	1	5
OG0001324	1	1	3	0	5
OG0001325	1	2	1	1	5
OG0001326	2	2	1	0	5
OG0001327	2	1	1	1	5
OG0001328	1	2	2	0	5
OG0001329	1	1	3	0	5
OG0001330	1	1	1	2	5
OG0001331	1	1	3	0	5
OG0001332	1	1	1	2	5
OG0001333	1	1	1	2	5
OG0001334	1	3	1	0	5
OG0001335	2	1	1	1	5
OG0001336	1	2	1	1	5
OG0001337	2	1	1	1	5
OG0001338	1	1	1	2	5
OG0001339	1	3	1	0	5
OG0001340	1	2	2	0	5
OG0001341	2	1	2	0	5
OG0001342	1	1	1	2	5
OG0001343	1	1	2	1	5
OG0001344	2	1	1	1	5
OG0001345	1	2	1	1	5
OG0001346	3	1	1	0	5
OG0001347	1	2	2	0	5
OG0001348	2	1	1	1	5
OG0001349	1	1	2	1	5
OG0001350	1	1	1	2	5
OG0001351	1	1	2	1	5
OG0001352	2	1	1	1	5
OG0001353	1	3	1	0	5
OG0001354	1	1	3	0	5
OG0001355	1	2	1	1	5
OG0001356	1	2	1	1	5
OG0001357	1	2	2	0	5
OG0001358	2	1	2	0	5
OG0001359	3	1	1	0	5
OG0001360	1	1	1	2	5
OG0001361	1	2	1	1	5
OG0001362	2	2	0	1	5
OG0001363	1	1	2	1	5
OG0001364	1	1	2	1	5
OG0001365	1	1	2	1	5
OG0001366	1	2	2	0	5
OG0001367	2	1	1	1	5
OG0001368	2	1	1	1	5
OG0001369	1	3	1	0	5
OG0001370	1	1	1	2	5
OG0001371	1	3	1	0	5
OG0001372	1	1	1	2	5
OG0001373	1	2	1	1	5
OG0001374	1	2	2	0	5
OG0001375	2	1	1	1	5
OG0001376	1	2	0	2	5
OG0001377	1	1	2	1	5
OG0001378	1	2	1	1	5
OG0001379	1	1	1	2	5
OG0001380	2	1	1	1	5
OG0001381	1	1	2	1	5
OG0001382	2	1	2	0	5
OG0001383	1	3	1	0	5
OG0001384	2	1	1	1	5
OG0001385	1	2	1	1	5
OG0001386	1	2	1	1	5
OG0001387	2	1	1	1	5
OG0001388	1	2	2	0	5
OG0001389	2	1	2	0	5
OG0001390	1	2	1	1	5
OG0001391	1	2	1	1	5
OG0001392	2	1	1	1	5
OG0001393	1	1	2	1	5
OG0001394	1	2	1	1	5
OG0001395	1	2	1	1	5
OG0001396	1	3	1	0	5
OG0001397	1	1	2	1	5
OG0001398	1	0	4	0	5
OG0001399	1	3	1	0	5
OG0001400	1	1	2	1	5
OG0001401	1	2	1	1	5
OG0001402	1	2	1	1	5
OG0001403	1	1	1	2	5
OG0001404	1	3	1	0	5
OG0001405	1	1	1	2	5
OG0001406	1	1	2	1	5
OG0001407	1	1	2	1	5
OG0001408	1	2	1	1	5
OG0001409	1	2	1	1	5
OG0001410	1	1	3	0	5
OG0001411	1	2	1	1	5
OG0001412	1	2	1	1	5
OG0001413	1	1	1	2	5
OG0001414	1	2	2	0	5
OG0001415	1	2	1	1	5
OG0001416	1	2	1	1	5
OG0001417	1	2	1	1	5
OG0001418	1	1	1	2	5
OG0001419	1	1	1	2	5
OG0001420	1	2	1	1	5
OG0001421	1	2	2	0	5
OG0001422	1	1	1	2	5
OG0001423	1	3	1	0	5
OG0001424	1	1	3	0	5
OG0001425	1	1	1	2	5
OG0001426	1	1	1	2	5
OG0001427	5	0	0	0	5
OG0001428	2	2	1	0	5
OG0001429	1	1	2	1	5
OG0001430	1	2	2	0	5
OG0001431	1	1	3	0	5
OG0001432	1	3	1	0	5
OG0001433	1	2	1	1	5
OG0001434	1	2	1	1	5
OG0001435	1	2	1	1	5
OG0001436	1	1	2	1	5
OG0001437	1	3	1	0	5
OG0001438	1	3	1	0	5
OG0001439	1	2	1	1	5
OG0001440	2	1	1	1	5
OG0001441	1	2	1	1	5
OG0001442	1	2	1	1	5
OG0001443	1	1	3	0	5
OG0001444	1	1	2	1	5
OG0001445	1	1	0	3	5
OG0001446	1	3	0	1	5
OG0001447	1	1	2	1	5
OG0001448	1	2	1	1	5
OG0001449	1	2	1	1	5
OG0001450	1	2	1	1	5
OG0001451	0	5	0	0	5
OG0001452	0	2	2	1	5
OG0001453	0	2	2	1	5
OG0001454	0	3	1	1	5
OG0001455	0	5	0	0	5
OG0001456	0	4	1	0	5
OG0001457	0	2	1	2	5
OG0001458	0	4	1	0	5
OG0001459	0	3	2	0	5
OG0001460	0	4	1	0	5
OG0001461	0	3	0	2	5
OG0001462	0	1	4	0	5
OG0001463	0	2	2	1	5
OG0001464	0	4	1	0	5
OG0001465	0	4	1	0	5
OG0001466	0	1	2	2	5
OG0001467	0	1	2	2	5
OG0001468	0	4	0	1	5
OG0001469	0	3	2	0	5
OG0001470	0	2	2	1	5
OG0001471	0	1	4	0	5
OG0001472	0	5	0	0	5
OG0001473	0	5	0	0	5
OG0001474	0	5	0	0	5
OG0001475	0	5	0	0	5
OG0001476	0	5	0	0	5
OG0001477	0	5	0	0	5
OG0001478	0	1	4	0	5
OG0001479	0	5	0	0	5
OG0001480	0	5	0	0	5
OG0001481	0	5	0	0	5
OG0001482	0	2	2	1	5
OG0001483	0	5	0	0	5
OG0001484	0	3	1	1	5
OG0001485	0	1	0	4	5
OG0001486	0	1	4	0	5
OG0001487	0	2	2	1	5
OG0001488	0	1	4	0	5
OG0001489	0	5	0	0	5
OG0001490	0	4	1	0	5
OG0001491	0	3	1	1	5
OG0001492	0	4	0	1	5
OG0001493	0	5	0	0	5
OG0001494	0	1	3	1	5
OG0001495	0	1	3	1	5
OG0001496	0	3	2	0	5
OG0001497	0	3	2	0	5
OG0001498	0	2	2	1	5
OG0001499	0	1	4	0	5
OG0001500	0	4	1	0	5
OG0001501	0	1	4	0	5
OG0001502	0	1	2	2	5
OG0001503	0	4	1	0	5
OG0001504	0	5	0	0	5
OG0001505	0	4	1	0	5
OG0001506	0	4	1	0	5
OG0001507	0	3	2	0	5
OG0001508	0	4	1	0	5
OG0001509	0	3	1	1	5
OG0001510	0	4	1	0	5
OG0001511	0	1	4	0	5
OG0001512	0	3	2	0	5
OG0001513	0	5	0	0	5
OG0001514	0	5	0	0	5
OG0001515	0	5	0	0	5
OG0001516	0	5	0	0	5
OG0001517	0	5	0	0	5
OG0001518	0	5	0	0	5
OG0001519	0	5	0	0	5
OG0001520	0	0	5	0	5
OG0001521	0	0	5	0	5
OG0001522	0	0	5	0	5
OG0001523	0	0	5	0	5
OG0001524	0	0	5	0	5
OG0001525	0	0	5	0	5
OG0001526	0	0	4	1	5
OG0001527	0	0	5	0	5
OG0001528	0	0	4	1	5
OG0001529	0	0	5	0	5
OG0001530	0	0	5	0	5
OG0001531	0	0	5	0	5
OG0001532	0	0	5	0	5
OG0001533	0	0	5	0	5
OG0001534	0	0	0	5	5
OG0001535	0	0	0	5	5
OG0001536	0	0	0	5	5
OG0001537	0	0	0	5	5
OG0001538	0	0	0	5	5
OG0001539	0	0	0	5	5
OG0001540	0	0	0	5	5
OG0001541	0	0	0	5	5
OG0001542	2	1	1	0	4
OG0001543	1	1	1	1	4
OG0001544	1	2	1	0	4
OG0001545	1	2	1	0	4
OG0001546	4	0	0	0	4
OG0001547	2	1	1	0	4
OG0001548	1	1	1	1	4
OG0001549	1	1	1	1	4
OG0001550	1	1	1	1	4
OG0001551	1	1	1	1	4
OG0001552	1	2	1	0	4
OG0001553	1	1	2	0	4
OG0001554	1	1	2	0	4
OG0001555	1	1	1	1	4
OG0001556	1	2	1	0	4
OG0001557	1	1	1	1	4
OG0001558	1	1	1	1	4
OG0001559	1	1	1	1	4
OG0001560	1	2	1	0	4
OG0001561	1	1	2	0	4
OG0001562	1	1	1	1	4
OG0001563	1	1	1	1	4
OG0001564	1	1	1	1	4
OG0001565	1	1	1	1	4
OG0001566	1	1	1	1	4
OG0001567	1	2	1	0	4
OG0001568	1	1	1	1	4
OG0001569	1	2	1	0	4
OG0001570	1	1	1	1	4
OG0001571	1	1	1	1	4
OG0001572	1	1	1	1	4
OG0001573	1	1	1	1	4
OG0001574	1	1	1	1	4
OG0001575	1	2	1	0	4
OG0001576	1	1	2	0	4
OG0001577	1	1	1	1	4
OG0001578	1	1	1	1	4
OG0001579	1	2	1	0	4
OG0001580	1	1	2	0	4
OG0001581	2	1	1	0	4
OG0001582	1	1	1	1	4
OG0001583	1	1	1	1	4
OG0001584	1	1	2	0	4
OG0001585	1	1	1	1	4
OG0001586	1	1	1	1	4
OG0001587	1	1	1	1	4
OG0001588	1	2	1	0	4
OG0001589	1	1	1	1	4
OG0001590	1	1	1	1	4
OG0001591	2	1	1	0	4
OG0001592	1	0	3	0	4
OG0001593	1	1	2	0	4
OG0001594	1	1	1	1	4
OG0001595	1	1	1	1	4
OG0001596	1	0	1	2	4
OG0001597	2	1	1	0	4
OG0001598	2	1	1	0	4
OG0001599	1	1	1	1	4
OG0001600	4	0	0	0	4
OG0001601	1	1	1	1	4
OG0001602	1	1	1	1	4
OG0001603	2	1	1	0	4
OG0001604	2	1	1	0	4
OG0001605	1	1	1	1	4
OG0001606	1	1	1	1	4
OG0001607	1	1	1	1	4
OG0001608	1	2	1	0	4
OG0001609	1	1	1	1	4
OG0001610	1	1	1	1	4
OG0001611	1	1	1	1	4
OG0001612	1	1	1	1	4
OG0001613	1	1	1	1	4
OG0001614	1	2	1	0	4
OG0001615	1	2	1	0	4
OG0001616	1	1	1	1	4
OG0001617	1	1	1	1	4
OG0001618	1	1	1	1	4
OG0001619	1	1	1	1	4
OG0001620	1	1	1	1	4
OG0001621	1	1	1	1	4
OG0001622	1	2	1	0	4
OG0001623	1	1	1	1	4
OG0001624	1	1	1	1	4
OG0001625	1	1	1	1	4
OG0001626	1	2	1	0	4
OG0001627	1	1	1	1	4
OG0001628	1	1	1	1	4
OG0001629	2	0	1	1	4
OG0001630	1	1	1	1	4
OG0001631	1	1	1	1	4
OG0001632	1	3	0	0	4
OG0001633	1	1	1	1	4
OG0001634	1	2	1	0	4
OG0001635	1	1	1	1	4
OG0001636	1	1	2	0	4
OG0001637	1	1	2	0	4
OG0001638	2	1	1	0	4
OG0001639	1	1	1	1	4
OG0001640	1	1	1	1	4
OG0001641	1	1	1	1	4
OG0001642	1	1	1	1	4
OG0001643	1	2	1	0	4
OG0001644	1	1	1	1	4
OG0001645	1	2	1	0	4
OG0001646	1	3	0	0	4
OG0001647	1	1	1	1	4
OG0001648	1	2	1	0	4
OG0001649	2	1	1	0	4
OG0001650	1	1	1	1	4
OG0001651	1	1	1	1	4
OG0001652	1	1	1	1	4
OG0001653	2	1	1	0	4
OG0001654	1	1	1	1	4
OG0001655	1	1	1	1	4
OG0001656	1	1	1	1	4
OG0001657	1	1	1	1	4
OG0001658	1	2	1	0	4
OG0001659	1	1	1	1	4
OG0001660	1	1	2	0	4
OG0001661	1	1	1	1	4
OG0001662	1	1	1	1	4
OG0001663	1	1	1	1	4
OG0001664	1	1	1	1	4
OG0001665	1	1	1	1	4
OG0001666	1	1	1	1	4
OG0001667	1	1	2	0	4
OG0001668	1	1	2	0	4
OG0001669	1	1	1	1	4
OG0001670	1	1	1	1	4
OG0001671	1	1	1	1	4
OG0001672	1	1	1	1	4
OG0001673	1	1	1	1	4
OG0001674	1	2	1	0	4
OG0001675	1	2	1	0	4
OG0001676	1	1	1	1	4
OG0001677	1	1	1	1	4
OG0001678	1	1	1	1	4
OG0001679	1	2	0	1	4
OG0001680	1	1	1	1	4
OG0001681	1	1	1	1	4
OG0001682	1	1	1	1	4
OG0001683	1	1	1	1	4
OG0001684	1	1	1	1	4
OG0001685	1	1	2	0	4
OG0001686	1	1	1	1	4
OG0001687	1	2	1	0	4
OG0001688	1	1	2	0	4
OG0001689	2	1	1	0	4
OG0001690	1	1	1	1	4
OG0001691	1	1	1	1	4
OG0001692	1	1	1	1	4
OG0001693	2	1	1	0	4
OG0001694	1	1	1	1	4
OG0001695	1	2	1	0	4
OG0001696	1	1	1	1	4
OG0001697	1	1	1	1	4
OG0001698	1	1	1	1	4
OG0001699	1	1	1	1	4
OG0001700	2	1	1	0	4
OG0001701	1	1	1	1	4
OG0001702	1	1	1	1	4
OG0001703	1	1	2	0	4
OG0001704	1	2	1	0	4
OG0001705	1	1	1	1	4
OG0001706	1	1	1	1	4
OG0001707	1	1	1	1	4
OG0001708	1	1	1	1	4
OG0001709	1	1	1	1	4
OG0001710	1	0	2	1	4
OG0001711	1	1	1	1	4
OG0001712	1	1	1	1	4
OG0001713	1	1	1	1	4
OG0001714	1	1	1	1	4
OG0001715	1	1	1	1	4
OG0001716	1	1	1	1	4
OG0001717	1	1	1	1	4
OG0001718	4	0	0	0	4
OG0001719	1	1	1	1	4
OG0001720	1	1	1	1	4
OG0001721	1	1	1	1	4
OG0001722	1	1	1	1	4
OG0001723	1	1	1	1	4
OG0001724	1	1	1	1	4
OG0001725	2	1	1	0	4
OG0001726	1	1	1	1	4
OG0001727	1	1	1	1	4
OG0001728	1	1	1	1	4
OG0001729	4	0	0	0	4
OG0001730	1	1	1	1	4
OG0001731	1	1	1	1	4
OG0001732	1	1	1	1	4
OG0001733	1	1	1	1	4
OG0001734	1	1	1	1	4
OG0001735	1	1	2	0	4
OG0001736	1	1	1	1	4
OG0001737	1	1	1	1	4
OG0001738	1	1	1	1	4
OG0001739	1	1	1	1	4
OG0001740	1	1	1	1	4
OG0001741	1	2	1	0	4
OG0001742	1	1	1	1	4
OG0001743	1	1	1	1	4
OG0001744	1	1	1	1	4
OG0001745	1	2	1	0	4
OG0001746	1	1	1	1	4
OG0001747	1	1	2	0	4
OG0001748	1	1	1	1	4
OG0001749	1	1	1	1	4
OG0001750	1	1	1	1	4
OG0001751	1	1	1	1	4
OG0001752	1	1	1	1	4
OG0001753	1	1	1	1	4
OG0001754	1	2	1	0	4
OG0001755	4	0	0	0	4
OG0001756	1	1	1	1	4
OG0001757	1	1	2	0	4
OG0001758	1	1	1	1	4
OG0001759	1	1	1	1	4
OG0001760	1	2	1	0	4
OG0001761	1	0	3	0	4
OG0001762	1	1	1	1	4
OG0001763	1	1	1	1	4
OG0001764	1	1	1	1	4
OG0001765	1	2	1	0	4
OG0001766	1	2	1	0	4
OG0001767	1	1	1	1	4
OG0001768	1	1	1	1	4
OG0001769	1	1	1	1	4
OG0001770	1	1	1	1	4
OG0001771	1	1	1	1	4
OG0001772	4	0	0	0	4
OG0001773	1	1	1	1	4
OG0001774	1	1	2	0	4
OG0001775	1	1	1	1	4
OG0001776	1	1	1	1	4
OG0001777	1	1	1	1	4
OG0001778	2	1	1	0	4
OG0001779	1	1	1	1	4
OG0001780	2	1	1	0	4
OG0001781	1	1	2	0	4
OG0001782	1	1	1	1	4
OG0001783	1	1	1	1	4
OG0001784	1	1	1	1	4
OG0001785	2	1	1	0	4
OG0001786	1	1	1	1	4
OG0001787	1	1	1	1	4
OG0001788	1	1	1	1	4
OG0001789	1	1	1	1	4
OG0001790	1	1	1	1	4
OG0001791	1	1	1	1	4
OG0001792	1	1	1	1	4
OG0001793	1	2	1	0	4
OG0001794	1	1	1	1	4
OG0001795	1	1	1	1	4
OG0001796	1	1	1	1	4
OG0001797	1	1	1	1	4
OG0001798	2	1	1	0	4
OG0001799	2	1	1	0	4
OG0001800	4	0	0	0	4
OG0001801	2	1	1	0	4
OG0001802	1	1	1	1	4
OG0001803	1	1	1	1	4
OG0001804	1	1	2	0	4
OG0001805	1	3	0	0	4
OG0001806	1	1	1	1	4
OG0001807	1	1	1	1	4
OG0001808	1	1	1	1	4
OG0001809	1	2	1	0	4
OG0001810	1	1	1	1	4
OG0001811	1	1	2	0	4
OG0001812	2	1	1	0	4
OG0001813	1	1	1	1	4
OG0001814	1	1	1	1	4
OG0001815	1	1	2	0	4
OG0001816	1	2	1	0	4
OG0001817	1	1	1	1	4
OG0001818	1	1	2	0	4
OG0001819	4	0	0	0	4
OG0001820	1	2	1	0	4
OG0001821	4	0	0	0	4
OG0001822	1	1	1	1	4
OG0001823	1	1	1	1	4
OG0001824	1	1	1	1	4
OG0001825	1	1	1	1	4
OG0001826	1	2	1	0	4
OG0001827	1	1	1	1	4
OG0001828	1	1	1	1	4
OG0001829	1	1	1	1	4
OG0001830	1	1	1	1	4
OG0001831	1	1	1	1	4
OG0001832	1	2	1	0	4
OG0001833	1	1	1	1	4
OG0001834	1	1	1	1	4
OG0001835	1	1	1	1	4
OG0001836	1	1	1	1	4
OG0001837	1	2	1	0	4
OG0001838	1	1	1	1	4
OG0001839	1	1	1	1	4
OG0001840	1	1	1	1	4
OG0001841	1	1	1	1	4
OG0001842	1	1	1	1	4
OG0001843	1	1	1	1	4
OG0001844	1	1	1	1	4
OG0001845	1	1	1	1	4
OG0001846	1	1	1	1	4
OG0001847	1	1	1	1	4
OG0001848	1	1	1	1	4
OG0001849	1	1	1	1	4
OG0001850	1	1	1	1	4
OG0001851	1	1	1	1	4
OG0001852	1	1	1	1	4
OG0001853	1	1	1	1	4
OG0001854	1	1	1	1	4
OG0001855	1	1	0	2	4
OG0001856	1	1	1	1	4
OG0001857	1	2	1	0	4
OG0001858	4	0	0	0	4
OG0001859	1	1	1	1	4
OG0001860	2	1	1	0	4
OG0001861	1	1	1	1	4
OG0001862	1	1	1	1	4
OG0001863	1	1	1	1	4
OG0001864	1	1	2	0	4
OG0001865	1	1	1	1	4
OG0001866	1	1	1	1	4
OG0001867	1	1	1	1	4
OG0001868	2	1	1	0	4
OG0001869	1	2	1	0	4
OG0001870	1	1	1	1	4
OG0001871	1	1	1	1	4
OG0001872	1	1	1	1	4
OG0001873	1	1	1	1	4
OG0001874	1	1	1	1	4
OG0001875	1	2	1	0	4
OG0001876	1	1	1	1	4
OG0001877	1	1	1	1	4
OG0001878	1	1	1	1	4
OG0001879	1	1	1	1	4
OG0001880	1	1	1	1	4
OG0001881	1	1	1	1	4
OG0001882	1	1	1	1	4
OG0001883	1	1	1	1	4
OG0001884	1	2	1	0	4
OG0001885	1	1	1	1	4
OG0001886	1	1	1	1	4
OG0001887	2	2	0	0	4
OG0001888	1	2	1	0	4
OG0001889	1	1	1	1	4
OG0001890	1	1	1	1	4
OG0001891	1	1	1	1	4
OG0001892	1	1	1	1	4
OG0001893	1	1	1	1	4
OG0001894	1	1	1	1	4
OG0001895	1	1	1	1	4
OG0001896	1	2	1	0	4
OG0001897	1	1	1	1	4
OG0001898	1	1	1	1	4
OG0001899	1	1	1	1	4
OG0001900	1	2	1	0	4
OG0001901	1	1	1	1	4
OG0001902	1	1	1	1	4
OG0001903	1	1	1	1	4
OG0001904	1	1	1	1	4
OG0001905	1	1	1	1	4
OG0001906	1	1	1	1	4
OG0001907	1	1	1	1	4
OG0001908	1	1	1	1	4
OG0001909	1	1	1	1	4
OG0001910	1	1	1	1	4
OG0001911	2	1	1	0	4
OG0001912	1	2	1	0	4
OG0001913	1	1	1	1	4
OG0001914	1	1	1	1	4
OG0001915	1	1	2	0	4
OG0001916	1	1	1	1	4
OG0001917	1	1	1	1	4
OG0001918	1	1	1	1	4
OG0001919	1	1	1	1	4
OG0001920	1	1	1	1	4
OG0001921	1	2	1	0	4
OG0001922	1	1	1	1	4
OG0001923	1	1	2	0	4
OG0001924	1	1	1	1	4
OG0001925	1	1	1	1	4
OG0001926	1	2	1	0	4
OG0001927	1	1	1	1	4
OG0001928	1	2	1	0	4
OG0001929	1	1	1	1	4
OG0001930	1	1	1	1	4
OG0001931	1	1	2	0	4
OG0001932	1	1	1	1	4
OG0001933	1	1	1	1	4
OG0001934	1	1	1	1	4
OG0001935	1	1	1	1	4
OG0001936	1	2	1	0	4
OG0001937	2	1	1	0	4
OG0001938	1	1	1	1	4
OG0001939	1	1	1	1	4
OG0001940	1	1	1	1	4
OG0001941	1	2	0	1	4
OG0001942	1	1	1	1	4
OG0001943	1	2	1	0	4
OG0001944	1	1	1	1	4
OG0001945	1	1	1	1	4
OG0001946	1	1	1	1	4
OG0001947	1	1	1	1	4
OG0001948	1	1	1	1	4
OG0001949	1	1	1	1	4
OG0001950	1	1	1	1	4
OG0001951	2	1	1	0	4
OG0001952	1	1	1	1	4
OG0001953	1	1	1	1	4
OG0001954	2	1	1	0	4
OG0001955	1	2	1	0	4
OG0001956	1	1	1	1	4
OG0001957	1	1	1	1	4
OG0001958	1	1	1	1	4
OG0001959	1	1	1	1	4
OG0001960	1	1	1	1	4
OG0001961	1	1	1	1	4
OG0001962	1	1	1	1	4
OG0001963	1	2	1	0	4
OG0001964	1	1	2	0	4
OG0001965	1	1	1	1	4
OG0001966	1	1	1	1	4
OG0001967	1	1	1	1	4
OG0001968	1	3	0	0	4
OG0001969	1	2	1	0	4
OG0001970	1	1	1	1	4
OG0001971	1	1	1	1	4
OG0001972	1	1	1	1	4
OG0001973	1	1	1	1	4
OG0001974	1	1	1	1	4
OG0001975	1	1	1	1	4
OG0001976	1	1	1	1	4
OG0001977	1	1	1	1	4
OG0001978	1	1	1	1	4
OG0001979	1	1	1	1	4
OG0001980	1	2	1	0	4
OG0001981	1	1	1	1	4
OG0001982	2	1	1	0	4
OG0001983	1	1	2	0	4
OG0001984	1	1	1	1	4
OG0001985	1	1	1	1	4
OG0001986	1	1	1	1	4
OG0001987	1	1	1	1	4
OG0001988	1	1	1	1	4
OG0001989	1	1	1	1	4
OG0001990	1	1	1	1	4
OG0001991	1	2	1	0	4
OG0001992	1	1	1	1	4
OG0001993	1	1	1	1	4
OG0001994	1	1	1	1	4
OG0001995	1	1	1	1	4
OG0001996	1	2	1	0	4
OG0001997	1	1	1	1	4
OG0001998	2	1	1	0	4
OG0001999	1	1	1	1	4
OG0002000	1	1	1	1	4
OG0002001	1	1	1	1	4
OG0002002	1	1	1	1	4
OG0002003	1	1	1	1	4
OG0002004	1	1	2	0	4
OG0002005	2	1	1	0	4
OG0002006	1	1	1	1	4
OG0002007	1	1	1	1	4
OG0002008	1	1	1	1	4
OG0002009	1	1	1	1	4
OG0002010	1	1	1	1	4
OG0002011	1	1	1	1	4
OG0002012	1	1	1	1	4
OG0002013	1	1	1	1	4
OG0002014	1	1	1	1	4
OG0002015	1	1	1	1	4
OG0002016	1	1	1	1	4
OG0002017	1	1	2	0	4
OG0002018	1	1	1	1	4
OG0002019	1	1	1	1	4
OG0002020	1	1	1	1	4
OG0002021	1	1	1	1	4
OG0002022	1	1	1	1	4
OG0002023	1	2	1	0	4
OG0002024	1	1	1	1	4
OG0002025	1	1	1	1	4
OG0002026	1	1	1	1	4
OG0002027	2	1	1	0	4
OG0002028	1	1	1	1	4
OG0002029	1	1	1	1	4
OG0002030	1	1	1	1	4
OG0002031	4	0	0	0	4
OG0002032	1	1	1	1	4
OG0002033	1	1	1	1	4
OG0002034	1	1	1	1	4
OG0002035	1	1	1	1	4
OG0002036	1	1	1	1	4
OG0002037	2	1	1	0	4
OG0002038	1	1	1	1	4
OG0002039	2	1	1	0	4
OG0002040	1	1	1	1	4
OG0002041	1	1	1	1	4
OG0002042	1	1	1	1	4
OG0002043	1	1	1	1	4
OG0002044	1	1	1	1	4
OG0002045	4	0	0	0	4
OG0002046	1	1	1	1	4
OG0002047	1	1	1	1	4
OG0002048	1	1	1	1	4
OG0002049	1	1	1	1	4
OG0002050	1	2	1	0	4
OG0002051	1	1	1	1	4
OG0002052	1	1	1	1	4
OG0002053	1	1	2	0	4
OG0002054	1	2	1	0	4
OG0002055	1	1	1	1	4
OG0002056	1	1	1	1	4
OG0002057	1	1	1	1	4
OG0002058	1	1	1	1	4
OG0002059	3	1	0	0	4
OG0002060	1	2	1	0	4
OG0002061	1	1	1	1	4
OG0002062	1	2	1	0	4
OG0002063	1	1	1	1	4
OG0002064	1	1	1	1	4
OG0002065	1	1	1	1	4
OG0002066	1	1	1	1	4
OG0002067	1	2	1	0	4
OG0002068	1	1	1	1	4
OG0002069	1	1	1	1	4
OG0002070	1	1	1	1	4
OG0002071	1	1	1	1	4
OG0002072	1	1	1	1	4
OG0002073	1	1	1	1	4
OG0002074	1	1	2	0	4
OG0002075	1	1	1	1	4
OG0002076	1	1	2	0	4
OG0002077	1	2	1	0	4
OG0002078	1	1	1	1	4
OG0002079	1	1	1	1	4
OG0002080	1	1	1	1	4
OG0002081	1	1	1	1	4
OG0002082	1	1	1	1	4
OG0002083	1	1	1	1	4
OG0002084	1	1	1	1	4
OG0002085	1	1	1	1	4
OG0002086	1	1	1	1	4
OG0002087	2	1	1	0	4
OG0002088	1	1	1	1	4
OG0002089	1	1	1	1	4
OG0002090	1	1	1	1	4
OG0002091	1	1	1	1	4
OG0002092	4	0	0	0	4
OG0002093	1	1	1	1	4
OG0002094	1	1	1	1	4
OG0002095	1	1	1	1	4
OG0002096	1	1	1	1	4
OG0002097	1	1	1	1	4
OG0002098	1	1	1	1	4
OG0002099	1	1	1	1	4
OG0002100	2	1	1	0	4
OG0002101	1	1	1	1	4
OG0002102	1	1	2	0	4
OG0002103	1	1	1	1	4
OG0002104	1	1	1	1	4
OG0002105	1	1	2	0	4
OG0002106	1	2	0	1	4
OG0002107	2	1	1	0	4
OG0002108	1	1	1	1	4
OG0002109	1	1	1	1	4
OG0002110	1	1	2	0	4
OG0002111	1	2	1	0	4
OG0002112	1	2	1	0	4
OG0002113	1	1	1	1	4
OG0002114	1	1	1	1	4
OG0002115	1	1	1	1	4
OG0002116	1	1	1	1	4
OG0002117	1	1	1	1	4
OG0002118	1	1	1	1	4
OG0002119	1	1	1	1	4
OG0002120	1	1	1	1	4
OG0002121	1	1	1	1	4
OG0002122	1	1	1	1	4
OG0002123	1	1	1	1	4
OG0002124	1	1	1	1	4
OG0002125	1	1	1	1	4
OG0002126	1	1	1	1	4
OG0002127	1	1	1	1	4
OG0002128	1	1	1	1	4
OG0002129	1	1	1	1	4
OG0002130	1	1	1	1	4
OG0002131	1	1	1	1	4
OG0002132	4	0	0	0	4
OG0002133	1	2	0	1	4
OG0002134	1	1	1	1	4
OG0002135	1	2	1	0	4
OG0002136	1	1	1	1	4
OG0002137	4	0	0	0	4
OG0002138	1	1	2	0	4
OG0002139	1	1	1	1	4
OG0002140	1	1	1	1	4
OG0002141	1	1	1	1	4
OG0002142	1	3	0	0	4
OG0002143	1	1	1	1	4
OG0002144	1	1	1	1	4
OG0002145	1	1	1	1	4
OG0002146	1	1	1	1	4
OG0002147	1	1	1	1	4
OG0002148	1	2	1	0	4
OG0002149	1	1	2	0	4
OG0002150	1	1	2	0	4
OG0002151	1	1	1	1	4
OG0002152	1	1	1	1	4
OG0002153	1	1	1	1	4
OG0002154	1	1	2	0	4
OG0002155	1	1	1	1	4
OG0002156	1	1	2	0	4
OG0002157	1	1	1	1	4
OG0002158	1	2	1	0	4
OG0002159	1	1	1	1	4
OG0002160	1	1	1	1	4
OG0002161	1	1	1	1	4
OG0002162	1	2	1	0	4
OG0002163	2	1	1	0	4
OG0002164	1	1	1	1	4
OG0002165	1	1	1	1	4
OG0002166	1	1	1	1	4
OG0002167	1	2	1	0	4
OG0002168	1	2	1	0	4
OG0002169	1	1	1	1	4
OG0002170	1	2	1	0	4
OG0002171	1	1	1	1	4
OG0002172	1	1	1	1	4
OG0002173	1	1	1	1	4
OG0002174	1	1	1	1	4
OG0002175	1	1	1	1	4
OG0002176	1	2	1	0	4
OG0002177	1	1	1	1	4
OG0002178	1	1	1	1	4
OG0002179	1	1	1	1	4
OG0002180	1	1	1	1	4
OG0002181	1	1	1	1	4
OG0002182	2	1	1	0	4
OG0002183	1	1	1	1	4
OG0002184	1	1	1	1	4
OG0002185	2	1	1	0	4
OG0002186	2	1	1	0	4
OG0002187	1	1	1	1	4
OG0002188	1	2	1	0	4
OG0002189	1	1	1	1	4
OG0002190	1	1	1	1	4
OG0002191	1	1	1	1	4
OG0002192	1	1	1	1	4
OG0002193	1	1	1	1	4
OG0002194	1	1	1	1	4
OG0002195	4	0	0	0	4
OG0002196	1	1	1	1	4
OG0002197	1	1	1	1	4
OG0002198	1	1	1	1	4
OG0002199	1	1	1	1	4
OG0002200	1	2	1	0	4
OG0002201	1	1	1	1	4
OG0002202	1	1	1	1	4
OG0002203	1	1	2	0	4
OG0002204	1	1	1	1	4
OG0002205	1	1	1	1	4
OG0002206	1	1	1	1	4
OG0002207	1	1	1	1	4
OG0002208	1	1	1	1	4
OG0002209	1	2	1	0	4
OG0002210	1	1	1	1	4
OG0002211	1	1	2	0	4
OG0002212	1	1	1	1	4
OG0002213	1	1	1	1	4
OG0002214	1	1	1	1	4
OG0002215	1	1	1	1	4
OG0002216	1	1	1	1	4
OG0002217	1	1	1	1	4
OG0002218	1	1	1	1	4
OG0002219	1	1	1	1	4
OG0002220	1	1	1	1	4
OG0002221	1	1	1	1	4
OG0002222	1	1	1	1	4
OG0002223	1	1	1	1	4
OG0002224	1	1	1	1	4
OG0002225	1	1	1	1	4
OG0002226	4	0	0	0	4
OG0002227	2	2	0	0	4
OG0002228	4	0	0	0	4
OG0002229	2	1	1	0	4
OG0002230	4	0	0	0	4
OG0002231	1	2	1	0	4
OG0002232	1	1	1	1	4
OG0002233	1	1	1	1	4
OG0002234	1	1	2	0	4
OG0002235	1	1	1	1	4
OG0002236	1	1	1	1	4
OG0002237	4	0	0	0	4
OG0002238	4	0	0	0	4
OG0002239	1	1	1	1	4
OG0002240	1	1	1	1	4
OG0002241	1	1	1	1	4
OG0002242	1	1	1	1	4
OG0002243	1	1	1	1	4
OG0002244	1	1	1	1	4
OG0002245	1	1	1	1	4
OG0002246	1	1	1	1	4
OG0002247	1	1	1	1	4
OG0002248	1	1	1	1	4
OG0002249	1	1	1	1	4
OG0002250	1	1	1	1	4
OG0002251	1	1	1	1	4
OG0002252	2	0	1	1	4
OG0002253	1	1	1	1	4
OG0002254	1	1	1	1	4
OG0002255	1	1	1	1	4
OG0002256	1	1	1	1	4
OG0002257	1	1	1	1	4
OG0002258	1	2	1	0	4
OG0002259	1	2	1	0	4
OG0002260	1	1	1	1	4
OG0002261	1	1	1	1	4
OG0002262	1	1	1	1	4
OG0002263	1	1	2	0	4
OG0002264	1	1	1	1	4
OG0002265	1	1	1	1	4
OG0002266	1	1	2	0	4
OG0002267	1	1	1	1	4
OG0002268	1	1	1	1	4
OG0002269	2	1	1	0	4
OG0002270	1	1	1	1	4
OG0002271	1	2	1	0	4
OG0002272	1	1	1	1	4
OG0002273	1	1	2	0	4
OG0002274	1	1	2	0	4
OG0002275	4	0	0	0	4
OG0002276	1	1	1	1	4
OG0002277	1	1	1	1	4
OG0002278	1	1	1	1	4
OG0002279	1	1	1	1	4
OG0002280	1	1	1	1	4
OG0002281	1	1	1	1	4
OG0002282	1	1	1	1	4
OG0002283	2	1	1	0	4
OG0002284	1	1	0	2	4
OG0002285	1	1	1	1	4
OG0002286	1	1	2	0	4
OG0002287	1	1	1	1	4
OG0002288	1	1	1	1	4
OG0002289	1	1	1	1	4
OG0002290	1	2	1	0	4
OG0002291	2	1	1	0	4
OG0002292	1	2	1	0	4
OG0002293	1	1	1	1	4
OG0002294	2	1	1	0	4
OG0002295	1	2	1	0	4
OG0002296	1	1	1	1	4
OG0002297	1	1	1	1	4
OG0002298	1	2	1	0	4
OG0002299	1	2	1	0	4
OG0002300	1	1	1	1	4
OG0002301	1	1	2	0	4
OG0002302	1	1	2	0	4
OG0002303	1	1	2	0	4
OG0002304	1	1	2	0	4
OG0002305	1	1	1	1	4
OG0002306	1	1	1	1	4
OG0002307	1	1	1	1	4
OG0002308	1	1	1	1	4
OG0002309	1	1	1	1	4
OG0002310	4	0	0	0	4
OG0002311	1	1	1	1	4
OG0002312	1	1	1	1	4
OG0002313	1	1	1	1	4
OG0002314	3	0	0	1	4
OG0002315	1	1	1	1	4
OG0002316	1	1	1	1	4
OG0002317	1	1	2	0	4
OG0002318	1	1	2	0	4
OG0002319	1	1	1	1	4
OG0002320	1	1	1	1	4
OG0002321	1	1	1	1	4
OG0002322	1	1	1	1	4
OG0002323	1	1	1	1	4
OG0002324	1	2	1	0	4
OG0002325	1	2	1	0	4
OG0002326	1	1	1	1	4
OG0002327	1	1	1	1	4
OG0002328	1	1	1	1	4
OG0002329	1	1	1	1	4
OG0002330	1	1	1	1	4
OG0002331	1	1	1	1	4
OG0002332	1	2	1	0	4
OG0002333	1	1	1	1	4
OG0002334	2	1	0	1	4
OG0002335	1	1	1	1	4
OG0002336	1	2	1	0	4
OG0002337	1	1	1	1	4
OG0002338	1	1	1	1	4
OG0002339	1	1	1	1	4
OG0002340	1	1	1	1	4
OG0002341	1	3	0	0	4
OG0002342	1	1	1	1	4
OG0002343	1	1	1	1	4
OG0002344	1	1	1	1	4
OG0002345	1	1	1	1	4
OG0002346	1	1	1	1	4
OG0002347	1	1	1	1	4
OG0002348	1	2	1	0	4
OG0002349	1	1	1	1	4
OG0002350	1	1	1	1	4
OG0002351	1	1	1	1	4
OG0002352	1	1	1	1	4
OG0002353	1	1	1	1	4
OG0002354	1	1	2	0	4
OG0002355	1	2	1	0	4
OG0002356	1	1	2	0	4
OG0002357	1	2	1	0	4
OG0002358	1	1	1	1	4
OG0002359	1	1	1	1	4
OG0002360	1	1	2	0	4
OG0002361	1	1	2	0	4
OG0002362	2	1	1	0	4
OG0002363	1	2	0	1	4
OG0002364	1	2	1	0	4
OG0002365	1	2	1	0	4
OG0002366	1	1	1	1	4
OG0002367	2	1	1	0	4
OG0002368	1	2	1	0	4
OG0002369	1	1	2	0	4
OG0002370	1	1	1	1	4
OG0002371	1	2	1	0	4
OG0002372	1	1	1	1	4
OG0002373	1	2	1	0	4
OG0002374	1	1	1	1	4
OG0002375	1	1	2	0	4
OG0002376	1	1	2	0	4
OG0002377	1	1	1	1	4
OG0002378	1	1	1	1	4
OG0002379	1	1	1	1	4
OG0002380	1	2	1	0	4
OG0002381	1	1	1	1	4
OG0002382	1	2	1	0	4
OG0002383	4	0	0	0	4
OG0002384	1	2	1	0	4
OG0002385	1	1	1	1	4
OG0002386	1	1	1	1	4
OG0002387	1	2	1	0	4
OG0002388	1	1	2	0	4
OG0002389	1	2	1	0	4
OG0002390	1	1	2	0	4
OG0002391	1	1	2	0	4
OG0002392	1	2	1	0	4
OG0002393	1	2	1	0	4
OG0002394	1	1	1	1	4
OG0002395	1	1	1	1	4
OG0002396	1	1	1	1	4
OG0002397	1	1	1	1	4
OG0002398	1	1	1	1	4
OG0002399	1	2	1	0	4
OG0002400	1	1	1	1	4
OG0002401	1	1	1	1	4
OG0002402	2	1	1	0	4
OG0002403	1	1	1	1	4
OG0002404	1	1	1	1	4
OG0002405	1	1	1	1	4
OG0002406	4	0	0	0	4
OG0002407	1	1	1	1	4
OG0002408	1	2	1	0	4
OG0002409	1	1	1	1	4
OG0002410	1	2	1	0	4
OG0002411	1	1	1	1	4
OG0002412	2	1	1	0	4
OG0002413	2	1	1	0	4
OG0002414	2	1	1	0	4
OG0002415	1	2	1	0	4
OG0002416	1	1	1	1	4
OG0002417	1	1	2	0	4
OG0002418	1	1	1	1	4
OG0002419	1	1	1	1	4
OG0002420	2	1	1	0	4
OG0002421	1	1	1	1	4
OG0002422	1	1	1	1	4
OG0002423	1	1	1	1	4
OG0002424	1	1	1	1	4
OG0002425	1	1	2	0	4
OG0002426	1	1	1	1	4
OG0002427	1	2	1	0	4
OG0002428	1	1	1	1	4
OG0002429	1	1	1	1	4
OG0002430	2	1	1	0	4
OG0002431	2	1	1	0	4
OG0002432	1	1	1	1	4
OG0002433	1	1	1	1	4
OG0002434	1	2	1	0	4
OG0002435	1	1	1	1	4
OG0002436	1	1	1	1	4
OG0002437	1	1	1	1	4
OG0002438	2	1	1	0	4
OG0002439	2	1	1	0	4
OG0002440	1	2	1	0	4
OG0002441	1	2	1	0	4
OG0002442	1	1	1	1	4
OG0002443	2	1	1	0	4
OG0002444	1	2	1	0	4
OG0002445	1	1	1	1	4
OG0002446	1	1	1	1	4
OG0002447	1	2	1	0	4
OG0002448	1	1	1	1	4
OG0002449	1	1	1	1	4
OG0002450	1	1	1	1	4
OG0002451	1	2	1	0	4
OG0002452	1	1	2	0	4
OG0002453	1	2	1	0	4
OG0002454	1	1	1	1	4
OG0002455	1	1	1	1	4
OG0002456	1	2	1	0	4
OG0002457	1	0	1	2	4
OG0002458	1	1	1	1	4
OG0002459	1	1	1	1	4
OG0002460	1	1	1	1	4
OG0002461	1	1	1	1	4
OG0002462	1	1	1	1	4
OG0002463	1	1	1	1	4
OG0002464	1	1	1	1	4
OG0002465	1	1	1	1	4
OG0002466	1	1	1	1	4
OG0002467	1	1	1	1	4
OG0002468	1	1	1	1	4
OG0002469	1	1	1	1	4
OG0002470	1	1	1	1	4
OG0002471	1	2	1	0	4
OG0002472	1	1	2	0	4
OG0002473	1	1	1	1	4
OG0002474	1	1	1	1	4
OG0002475	1	1	1	1	4
OG0002476	1	2	1	0	4
OG0002477	1	1	1	1	4
OG0002478	2	1	1	0	4
OG0002479	1	1	1	1	4
OG0002480	1	2	1	0	4
OG0002481	1	1	1	1	4
OG0002482	1	1	1	1	4
OG0002483	1	1	1	1	4
OG0002484	1	1	1	1	4
OG0002485	1	1	1	1	4
OG0002486	1	1	1	1	4
OG0002487	1	1	1	1	4
OG0002488	1	1	1	1	4
OG0002489	1	1	1	1	4
OG0002490	1	1	2	0	4
OG0002491	2	1	1	0	4
OG0002492	1	1	1	1	4
OG0002493	1	1	2	0	4
OG0002494	1	1	1	1	4
OG0002495	1	1	1	1	4
OG0002496	1	1	1	1	4
OG0002497	1	1	1	1	4
OG0002498	1	2	1	0	4
OG0002499	1	1	1	1	4
OG0002500	1	1	1	1	4
OG0002501	1	2	1	0	4
OG0002502	2	1	1	0	4
OG0002503	1	1	1	1	4
OG0002504	1	1	1	1	4
OG0002505	1	2	1	0	4
OG0002506	1	1	1	1	4
OG0002507	1	1	1	1	4
OG0002508	1	1	0	2	4
OG0002509	2	1	1	0	4
OG0002510	1	1	1	1	4
OG0002511	1	1	1	1	4
OG0002512	2	1	1	0	4
OG0002513	1	1	1	1	4
OG0002514	1	1	1	1	4
OG0002515	1	1	1	1	4
OG0002516	1	1	1	1	4
OG0002517	1	2	1	0	4
OG0002518	1	1	2	0	4
OG0002519	1	2	1	0	4
OG0002520	1	1	1	1	4
OG0002521	1	1	1	1	4
OG0002522	1	2	1	0	4
OG0002523	1	2	1	0	4
OG0002524	1	1	1	1	4
OG0002525	1	2	1	0	4
OG0002526	1	1	1	1	4
OG0002527	1	1	1	1	4
OG0002528	1	0	3	0	4
OG0002529	1	1	1	1	4
OG0002530	1	1	1	1	4
OG0002531	1	1	1	1	4
OG0002532	1	1	1	1	4
OG0002533	1	1	1	1	4
OG0002534	1	1	1	1	4
OG0002535	1	2	1	0	4
OG0002536	1	1	1	1	4
OG0002537	1	2	1	0	4
OG0002538	1	1	1	1	4
OG0002539	1	1	1	1	4
OG0002540	1	1	1	1	4
OG0002541	1	2	1	0	4
OG0002542	1	1	1	1	4
OG0002543	1	1	1	1	4
OG0002544	1	0	1	2	4
OG0002545	1	1	1	1	4
OG0002546	1	1	1	1	4
OG0002547	1	1	2	0	4
OG0002548	1	1	1	1	4
OG0002549	1	2	1	0	4
OG0002550	1	1	2	0	4
OG0002551	1	1	1	1	4
OG0002552	1	1	2	0	4
OG0002553	1	1	2	0	4
OG0002554	1	1	1	1	4
OG0002555	1	1	1	1	4
OG0002556	1	1	2	0	4
OG0002557	1	1	1	1	4
OG0002558	1	1	1	1	4
OG0002559	1	1	1	1	4
OG0002560	1	1	2	0	4
OG0002561	1	0	1	2	4
OG0002562	1	2	1	0	4
OG0002563	1	1	2	0	4
OG0002564	1	1	1	1	4
OG0002565	1	1	1	1	4
OG0002566	1	1	1	1	4
OG0002567	1	2	1	0	4
OG0002568	1	1	1	1	4
OG0002569	1	1	1	1	4
OG0002570	1	2	1	0	4
OG0002571	1	1	1	1	4
OG0002572	1	1	1	1	4
OG0002573	1	1	1	1	4
OG0002574	1	1	1	1	4
OG0002575	1	1	1	1	4
OG0002576	1	2	1	0	4
OG0002577	1	1	1	1	4
OG0002578	1	1	1	1	4
OG0002579	1	1	2	0	4
OG0002580	1	2	1	0	4
OG0002581	1	1	2	0	4
OG0002582	1	1	1	1	4
OG0002583	2	1	1	0	4
OG0002584	1	3	0	0	4
OG0002585	1	1	1	1	4
OG0002586	1	1	1	1	4
OG0002587	1	1	1	1	4
OG0002588	1	1	1	1	4
OG0002589	1	2	1	0	4
OG0002590	1	1	2	0	4
OG0002591	1	1	1	1	4
OG0002592	1	3	0	0	4
OG0002593	2	1	1	0	4
OG0002594	1	1	1	1	4
OG0002595	1	1	1	1	4
OG0002596	2	1	1	0	4
OG0002597	1	1	1	1	4
OG0002598	1	1	1	1	4
OG0002599	1	1	1	1	4
OG0002600	1	1	1	1	4
OG0002601	1	2	0	1	4
OG0002602	1	1	1	1	4
OG0002603	1	1	1	1	4
OG0002604	1	1	1	1	4
OG0002605	1	1	1	1	4
OG0002606	1	1	1	1	4
OG0002607	1	1	1	1	4
OG0002608	1	3	0	0	4
OG0002609	1	1	1	1	4
OG0002610	1	1	1	1	4
OG0002611	1	1	1	1	4
OG0002612	1	1	1	1	4
OG0002613	1	1	1	1	4
OG0002614	1	2	1	0	4
OG0002615	1	1	2	0	4
OG0002616	1	1	1	1	4
OG0002617	1	1	1	1	4
OG0002618	1	1	1	1	4
OG0002619	1	1	1	1	4
OG0002620	1	1	1	1	4
OG0002621	1	1	1	1	4
OG0002622	1	1	1	1	4
OG0002623	1	2	1	0	4
OG0002624	1	1	1	1	4
OG0002625	1	1	2	0	4
OG0002626	2	1	1	0	4
OG0002627	1	1	1	1	4
OG0002628	1	2	1	0	4
OG0002629	1	1	1	1	4
OG0002630	1	1	1	1	4
OG0002631	1	1	1	1	4
OG0002632	1	1	1	1	4
OG0002633	1	2	1	0	4
OG0002634	1	1	1	1	4
OG0002635	1	1	2	0	4
OG0002636	1	1	1	1	4
OG0002637	1	1	1	1	4
OG0002638	1	1	1	1	4
OG0002639	1	1	1	1	4
OG0002640	1	2	1	0	4
OG0002641	1	3	0	0	4
OG0002642	1	1	1	1	4
OG0002643	1	1	1	1	4
OG0002644	1	1	1	1	4
OG0002645	1	1	1	1	4
OG0002646	1	1	1	1	4
OG0002647	1	2	1	0	4
OG0002648	2	1	1	0	4
OG0002649	1	1	2	0	4
OG0002650	2	1	1	0	4
OG0002651	1	1	2	0	4
OG0002652	1	2	1	0	4
OG0002653	1	1	1	1	4
OG0002654	1	1	1	1	4
OG0002655	1	2	1	0	4
OG0002656	1	1	1	1	4
OG0002657	1	2	1	0	4
OG0002658	1	1	1	1	4
OG0002659	1	1	2	0	4
OG0002660	1	1	1	1	4
OG0002661	1	1	1	1	4
OG0002662	1	2	0	1	4
OG0002663	1	2	1	0	4
OG0002664	1	1	2	0	4
OG0002665	1	1	1	1	4
OG0002666	1	1	1	1	4
OG0002667	2	1	1	0	4
OG0002668	1	1	1	1	4
OG0002669	1	1	1	1	4
OG0002670	2	1	1	0	4
OG0002671	1	1	2	0	4
OG0002672	1	1	1	1	4
OG0002673	1	1	1	1	4
OG0002674	2	0	2	0	4
OG0002675	1	1	1	1	4
OG0002676	1	1	1	1	4
OG0002677	1	1	1	1	4
OG0002678	1	2	1	0	4
OG0002679	1	1	1	1	4
OG0002680	1	2	1	0	4
OG0002681	1	1	1	1	4
OG0002682	1	1	1	1	4
OG0002683	1	1	1	1	4
OG0002684	1	1	1	1	4
OG0002685	1	1	2	0	4
OG0002686	1	1	1	1	4
OG0002687	1	1	1	1	4
OG0002688	1	1	1	1	4
OG0002689	1	2	1	0	4
OG0002690	1	2	1	0	4
OG0002691	1	1	1	1	4
OG0002692	1	1	1	1	4
OG0002693	1	1	2	0	4
OG0002694	1	2	1	0	4
OG0002695	1	1	1	1	4
OG0002696	1	1	1	1	4
OG0002697	2	1	1	0	4
OG0002698	4	0	0	0	4
OG0002699	1	1	1	1	4
OG0002700	1	1	1	1	4
OG0002701	1	1	1	1	4
OG0002702	1	1	1	1	4
OG0002703	2	1	1	0	4
OG0002704	1	1	1	1	4
OG0002705	1	1	1	1	4
OG0002706	1	1	2	0	4
OG0002707	1	1	1	1	4
OG0002708	1	1	1	1	4
OG0002709	1	1	1	1	4
OG0002710	1	2	1	0	4
OG0002711	1	1	1	1	4
OG0002712	1	1	1	1	4
OG0002713	1	1	1	1	4
OG0002714	1	1	1	1	4
OG0002715	1	1	1	1	4
OG0002716	1	1	1	1	4
OG0002717	1	1	1	1	4
OG0002718	1	1	2	0	4
OG0002719	1	1	1	1	4
OG0002720	1	1	1	1	4
OG0002721	1	1	1	1	4
OG0002722	1	1	1	1	4
OG0002723	1	1	1	1	4
OG0002724	1	1	1	1	4
OG0002725	1	1	1	1	4
OG0002726	1	1	1	1	4
OG0002727	1	1	2	0	4
OG0002728	1	1	1	1	4
OG0002729	1	1	2	0	4
OG0002730	1	2	1	0	4
OG0002731	1	1	1	1	4
OG0002732	1	2	1	0	4
OG0002733	1	1	1	1	4
OG0002734	1	1	1	1	4
OG0002735	1	1	2	0	4
OG0002736	1	1	1	1	4
OG0002737	1	1	1	1	4
OG0002738	1	1	1	1	4
OG0002739	1	1	1	1	4
OG0002740	1	2	1	0	4
OG0002741	1	1	2	0	4
OG0002742	1	2	1	0	4
OG0002743	1	1	1	1	4
OG0002744	1	1	1	1	4
OG0002745	4	0	0	0	4
OG0002746	1	1	1	1	4
OG0002747	1	1	2	0	4
OG0002748	1	1	1	1	4
OG0002749	1	1	1	1	4
OG0002750	4	0	0	0	4
OG0002751	1	1	1	1	4
OG0002752	1	1	1	1	4
OG0002753	1	1	2	0	4
OG0002754	1	1	1	1	4
OG0002755	1	1	1	1	4
OG0002756	1	1	1	1	4
OG0002757	1	1	1	1	4
OG0002758	1	0	1	2	4
OG0002759	1	1	1	1	4
OG0002760	1	1	1	1	4
OG0002761	1	1	1	1	4
OG0002762	1	1	1	1	4
OG0002763	1	1	1	1	4
OG0002764	1	1	2	0	4
OG0002765	1	1	1	1	4
OG0002766	1	2	1	0	4
OG0002767	1	1	1	1	4
OG0002768	1	1	1	1	4
OG0002769	1	1	1	1	4
OG0002770	1	1	1	1	4
OG0002771	1	1	1	1	4
OG0002772	1	1	1	1	4
OG0002773	1	1	1	1	4
OG0002774	1	1	1	1	4
OG0002775	1	1	1	1	4
OG0002776	1	1	1	1	4
OG0002777	1	1	1	1	4
OG0002778	1	1	1	1	4
OG0002779	1	1	1	1	4
OG0002780	1	1	1	1	4
OG0002781	1	1	1	1	4
OG0002782	1	1	1	1	4
OG0002783	1	1	1	1	4
OG0002784	1	1	1	1	4
OG0002785	0	1	3	0	4
OG0002786	0	1	1	2	4
OG0002787	0	4	0	0	4
OG0002788	0	3	1	0	4
OG0002789	0	1	2	1	4
OG0002790	0	4	0	0	4
OG0002791	0	1	1	2	4
OG0002792	0	2	2	0	4
OG0002793	0	2	1	1	4
OG0002794	0	4	0	0	4
OG0002795	0	4	0	0	4
OG0002796	0	2	1	1	4
OG0002797	0	3	0	1	4
OG0002798	0	1	2	1	4
OG0002799	0	4	0	0	4
OG0002800	0	1	1	2	4
OG0002801	0	4	0	0	4
OG0002802	0	1	2	1	4
OG0002803	0	2	2	0	4
OG0002804	0	1	1	2	4
OG0002805	0	2	1	1	4
OG0002806	0	1	2	1	4
OG0002807	0	2	0	2	4
OG0002808	0	4	0	0	4
OG0002809	0	3	0	1	4
OG0002810	0	4	0	0	4
OG0002811	0	3	1	0	4
OG0002812	0	1	1	2	4
OG0002813	0	1	3	0	4
OG0002814	0	4	0	0	4
OG0002815	0	1	1	2	4
OG0002816	0	4	0	0	4
OG0002817	0	3	1	0	4
OG0002818	0	4	0	0	4
OG0002819	0	4	0	0	4
OG0002820	0	2	2	0	4
OG0002821	0	2	1	1	4
OG0002822	0	1	3	0	4
OG0002823	0	1	1	2	4
OG0002824	0	4	0	0	4
OG0002825	0	2	2	0	4
OG0002826	0	2	2	0	4
OG0002827	0	2	1	1	4
OG0002828	0	3	1	0	4
OG0002829	0	4	0	0	4
OG0002830	0	1	1	2	4
OG0002831	0	2	0	2	4
OG0002832	0	4	0	0	4
OG0002833	0	4	0	0	4
OG0002834	0	2	1	1	4
OG0002835	0	4	0	0	4
OG0002836	0	2	2	0	4
OG0002837	0	4	0	0	4
OG0002838	0	4	0	0	4
OG0002839	0	4	0	0	4
OG0002840	0	1	2	1	4
OG0002841	0	4	0	0	4
OG0002842	0	1	2	1	4
OG0002843	0	1	2	1	4
OG0002844	0	4	0	0	4
OG0002845	0	2	1	1	4
OG0002846	0	4	0	0	4
OG0002847	0	4	0	0	4
OG0002848	0	4	0	0	4
OG0002849	0	3	0	1	4
OG0002850	0	2	1	1	4
OG0002851	0	4	0	0	4
OG0002852	0	2	1	1	4
OG0002853	0	4	0	0	4
OG0002854	0	3	1	0	4
OG0002855	0	1	2	1	4
OG0002856	0	3	1	0	4
OG0002857	0	3	1	0	4
OG0002858	0	2	1	1	4
OG0002859	0	1	2	1	4
OG0002860	0	1	2	1	4
OG0002861	0	1	1	2	4
OG0002862	0	4	0	0	4
OG0002863	0	1	1	2	4
OG0002864	0	2	1	1	4
OG0002865	0	4	0	0	4
OG0002866	0	1	1	2	4
OG0002867	0	1	2	1	4
OG0002868	0	3	1	0	4
OG0002869	0	1	3	0	4
OG0002870	0	1	2	1	4
OG0002871	0	4	0	0	4
OG0002872	0	3	1	0	4
OG0002873	0	1	2	1	4
OG0002874	0	1	3	0	4
OG0002875	0	1	2	1	4
OG0002876	0	1	1	2	4
OG0002877	0	1	2	1	4
OG0002878	0	1	2	1	4
OG0002879	0	2	2	0	4
OG0002880	0	4	0	0	4
OG0002881	0	2	2	0	4
OG0002882	0	2	1	1	4
OG0002883	0	4	0	0	4
OG0002884	0	1	2	1	4
OG0002885	0	1	1	2	4
OG0002886	0	4	0	0	4
OG0002887	0	4	0	0	4
OG0002888	0	3	1	0	4
OG0002889	0	3	1	0	4
OG0002890	0	3	1	0	4
OG0002891	0	4	0	0	4
OG0002892	0	4	0	0	4
OG0002893	0	4	0	0	4
OG0002894	0	4	0	0	4
OG0002895	0	2	2	0	4
OG0002896	0	4	0	0	4
OG0002897	0	1	3	0	4
OG0002898	0	3	1	0	4
OG0002899	0	4	0	0	4
OG0002900	0	4	0	0	4
OG0002901	0	3	1	0	4
OG0002902	0	2	2	0	4
OG0002903	0	3	1	0	4
OG0002904	0	3	0	1	4
OG0002905	0	1	3	0	4
OG0002906	0	4	0	0	4
OG0002907	0	4	0	0	4
OG0002908	0	1	1	2	4
OG0002909	0	2	2	0	4
OG0002910	0	2	1	1	4
OG0002911	0	4	0	0	4
OG0002912	0	2	2	0	4
OG0002913	0	4	0	0	4
OG0002914	0	2	1	1	4
OG0002915	0	4	0	0	4
OG0002916	0	4	0	0	4
OG0002917	0	4	0	0	4
OG0002918	0	1	3	0	4
OG0002919	0	4	0	0	4
OG0002920	0	4	0	0	4
OG0002921	0	0	3	1	4
OG0002922	0	0	3	1	4
OG0002923	0	0	4	0	4
OG0002924	0	0	4	0	4
OG0002925	0	0	4	0	4
OG0002926	0	0	4	0	4
OG0002927	0	0	3	1	4
OG0002928	0	0	4	0	4
OG0002929	0	0	4	0	4
OG0002930	0	0	4	0	4
OG0002931	0	0	4	0	4
OG0002932	0	0	4	0	4
OG0002933	0	0	4	0	4
OG0002934	0	0	4	0	4
OG0002935	0	0	4	0	4
OG0002936	0	0	4	0	4
OG0002937	0	0	4	0	4
OG0002938	0	0	4	0	4
OG0002939	0	0	4	0	4
OG0002940	0	0	4	0	4
OG0002941	0	0	4	0	4
OG0002942	0	0	4	0	4
OG0002943	0	0	0	4	4
OG0002944	0	0	0	4	4
OG0002945	0	0	0	4	4
OG0002946	0	0	0	4	4
OG0002947	0	0	0	4	4
OG0002948	0	0	0	4	4
OG0002949	0	0	0	4	4
OG0002950	0	0	0	4	4
OG0002951	0	0	0	4	4
OG0002952	0	0	0	4	4
OG0002953	0	0	0	4	4
OG0002954	0	0	0	4	4
OG0002955	0	0	0	4	4
OG0002956	1	1	1	0	3
OG0002957	3	0	0	0	3
OG0002958	1	1	1	0	3
OG0002959	1	1	1	0	3
OG0002960	1	1	1	0	3
OG0002961	3	0	0	0	3
OG0002962	1	1	1	0	3
OG0002963	1	1	1	0	3
OG0002964	1	1	1	0	3
OG0002965	1	1	1	0	3
OG0002966	1	1	1	0	3
OG0002967	1	1	1	0	3
OG0002968	1	1	1	0	3
OG0002969	1	1	1	0	3
OG0002970	1	1	1	0	3
OG0002971	1	1	1	0	3
OG0002972	1	1	1	0	3
OG0002973	1	1	1	0	3
OG0002974	1	1	1	0	3
OG0002975	3	0	0	0	3
OG0002976	1	1	1	0	3
OG0002977	1	1	1	0	3
OG0002978	1	1	1	0	3
OG0002979	1	1	1	0	3
OG0002980	1	1	1	0	3
OG0002981	3	0	0	0	3
OG0002982	1	1	1	0	3
OG0002983	1	1	1	0	3
OG0002984	1	1	1	0	3
OG0002985	1	0	2	0	3
OG0002986	1	0	1	1	3
OG0002987	1	1	1	0	3
OG0002988	1	1	1	0	3
OG0002989	1	1	1	0	3
OG0002990	1	1	1	0	3
OG0002991	1	1	1	0	3
OG0002992	1	1	1	0	3
OG0002993	1	1	1	0	3
OG0002994	1	1	1	0	3
OG0002995	1	1	1	0	3
OG0002996	1	1	1	0	3
OG0002997	1	1	1	0	3
OG0002998	1	1	1	0	3
OG0002999	1	1	1	0	3
OG0003000	1	1	1	0	3
OG0003001	1	1	1	0	3
OG0003002	1	1	1	0	3
OG0003003	3	0	0	0	3
OG0003004	1	1	1	0	3
OG0003005	1	1	1	0	3
OG0003006	1	1	1	0	3
OG0003007	1	1	1	0	3
OG0003008	1	1	1	0	3
OG0003009	3	0	0	0	3
OG0003010	1	1	1	0	3
OG0003011	1	1	1	0	3
OG0003012	1	1	1	0	3
OG0003013	3	0	0	0	3
OG0003014	1	1	1	0	3
OG0003015	1	1	1	0	3
OG0003016	1	1	1	0	3
OG0003017	1	1	1	0	3
OG0003018	1	1	1	0	3
OG0003019	1	1	1	0	3
OG0003020	1	0	1	1	3
OG0003021	1	1	1	0	3
OG0003022	1	1	1	0	3
OG0003023	1	1	1	0	3
OG0003024	1	1	0	1	3
OG0003025	1	1	1	0	3
OG0003026	3	0	0	0	3
OG0003027	1	1	1	0	3
OG0003028	1	1	1	0	3
OG0003029	1	1	1	0	3
OG0003030	1	1	1	0	3
OG0003031	1	1	1	0	3
OG0003032	3	0	0	0	3
OG0003033	1	1	1	0	3
OG0003034	1	1	1	0	3
OG0003035	1	1	1	0	3
OG0003036	3	0	0	0	3
OG0003037	1	1	1	0	3
OG0003038	1	1	1	0	3
OG0003039	1	0	2	0	3
OG0003040	1	1	1	0	3
OG0003041	1	1	1	0	3
OG0003042	3	0	0	0	3
OG0003043	3	0	0	0	3
OG0003044	1	2	0	0	3
OG0003045	1	1	1	0	3
OG0003046	1	1	1	0	3
OG0003047	1	1	1	0	3
OG0003048	1	0	1	1	3
OG0003049	1	1	1	0	3
OG0003050	1	1	1	0	3
OG0003051	1	1	1	0	3
OG0003052	1	1	1	0	3
OG0003053	1	1	1	0	3
OG0003054	2	0	1	0	3
OG0003055	1	1	1	0	3
OG0003056	1	1	1	0	3
OG0003057	1	1	0	1	3
OG0003058	1	1	0	1	3
OG0003059	1	1	1	0	3
OG0003060	1	0	2	0	3
OG0003061	1	1	1	0	3
OG0003062	1	1	1	0	3
OG0003063	1	1	1	0	3
OG0003064	1	1	1	0	3
OG0003065	1	0	2	0	3
OG0003066	1	1	1	0	3
OG0003067	3	0	0	0	3
OG0003068	1	1	1	0	3
OG0003069	1	1	1	0	3
OG0003070	1	1	1	0	3
OG0003071	2	1	0	0	3
OG0003072	1	0	2	0	3
OG0003073	1	1	1	0	3
OG0003074	1	1	1	0	3
OG0003075	1	1	0	1	3
OG0003076	1	1	1	0	3
OG0003077	1	1	1	0	3
OG0003078	1	1	0	1	3
OG0003079	3	0	0	0	3
OG0003080	1	1	1	0	3
OG0003081	1	1	0	1	3
OG0003082	3	0	0	0	3
OG0003083	1	0	2	0	3
OG0003084	1	1	1	0	3
OG0003085	1	0	1	1	3
OG0003086	1	1	1	0	3
OG0003087	1	1	1	0	3
OG0003088	3	0	0	0	3
OG0003089	1	1	1	0	3
OG0003090	1	1	1	0	3
OG0003091	1	1	1	0	3
OG0003092	1	1	1	0	3
OG0003093	1	1	1	0	3
OG0003094	1	1	1	0	3
OG0003095	1	1	1	0	3
OG0003096	1	1	1	0	3
OG0003097	2	0	1	0	3
OG0003098	1	1	1	0	3
OG0003099	1	0	1	1	3
OG0003100	1	1	0	1	3
OG0003101	1	1	1	0	3
OG0003102	1	1	1	0	3
OG0003103	1	1	1	0	3
OG0003104	1	1	1	0	3
OG0003105	1	1	1	0	3
OG0003106	1	1	1	0	3
OG0003107	1	1	1	0	3
OG0003108	1	1	1	0	3
OG0003109	1	1	1	0	3
OG0003110	1	1	1	0	3
OG0003111	3	0	0	0	3
OG0003112	1	1	1	0	3
OG0003113	1	1	0	1	3
OG0003114	1	1	1	0	3
OG0003115	2	0	0	1	3
OG0003116	1	1	1	0	3
OG0003117	1	1	1	0	3
OG0003118	1	1	1	0	3
OG0003119	1	1	1	0	3
OG0003120	1	1	1	0	3
OG0003121	1	1	1	0	3
OG0003122	1	1	1	0	3
OG0003123	1	1	1	0	3
OG0003124	1	1	1	0	3
OG0003125	1	1	1	0	3
OG0003126	1	1	1	0	3
OG0003127	1	1	1	0	3
OG0003128	3	0	0	0	3
OG0003129	1	1	1	0	3
OG0003130	1	0	1	1	3
OG0003131	1	1	1	0	3
OG0003132	3	0	0	0	3
OG0003133	3	0	0	0	3
OG0003134	1	1	1	0	3
OG0003135	1	1	1	0	3
OG0003136	1	1	1	0	3
OG0003137	1	1	1	0	3
OG0003138	1	1	1	0	3
OG0003139	1	1	0	1	3
OG0003140	1	0	1	1	3
OG0003141	1	1	1	0	3
OG0003142	1	1	1	0	3
OG0003143	1	1	1	0	3
OG0003144	1	1	1	0	3
OG0003145	1	1	1	0	3
OG0003146	1	1	1	0	3
OG0003147	1	1	1	0	3
OG0003148	1	1	1	0	3
OG0003149	1	1	1	0	3
OG0003150	1	1	1	0	3
OG0003151	1	1	0	1	3
OG0003152	1	1	1	0	3
OG0003153	1	0	2	0	3
OG0003154	1	1	1	0	3
OG0003155	1	1	1	0	3
OG0003156	1	0	1	1	3
OG0003157	1	1	0	1	3
OG0003158	1	1	1	0	3
OG0003159	1	0	2	0	3
OG0003160	1	1	0	1	3
OG0003161	1	1	1	0	3
OG0003162	1	0	1	1	3
OG0003163	1	1	1	0	3
OG0003164	1	1	1	0	3
OG0003165	1	1	1	0	3
OG0003166	1	1	1	0	3
OG0003167	1	1	1	0	3
OG0003168	1	1	1	0	3
OG0003169	1	1	1	0	3
OG0003170	1	0	1	1	3
OG0003171	3	0	0	0	3
OG0003172	1	1	1	0	3
OG0003173	1	1	1	0	3
OG0003174	1	1	1	0	3
OG0003175	1	1	1	0	3
OG0003176	1	1	1	0	3
OG0003177	1	1	1	0	3
OG0003178	1	1	1	0	3
OG0003179	1	0	1	1	3
OG0003180	1	1	1	0	3
OG0003181	1	1	1	0	3
OG0003182	1	1	1	0	3
OG0003183	1	1	1	0	3
OG0003184	1	1	1	0	3
OG0003185	1	1	1	0	3
OG0003186	1	1	1	0	3
OG0003187	1	1	1	0	3
OG0003188	1	1	1	0	3
OG0003189	1	1	1	0	3
OG0003190	1	1	1	0	3
OG0003191	1	1	1	0	3
OG0003192	2	1	0	0	3
OG0003193	1	1	1	0	3
OG0003194	3	0	0	0	3
OG0003195	1	1	1	0	3
OG0003196	1	1	1	0	3
OG0003197	1	1	1	0	3
OG0003198	1	0	2	0	3
OG0003199	1	0	1	1	3
OG0003200	1	1	0	1	3
OG0003201	1	1	1	0	3
OG0003202	2	1	0	0	3
OG0003203	1	1	1	0	3
OG0003204	1	1	1	0	3
OG0003205	1	1	1	0	3
OG0003206	1	1	0	1	3
OG0003207	1	1	1	0	3
OG0003208	1	1	1	0	3
OG0003209	1	1	1	0	3
OG0003210	1	1	1	0	3
OG0003211	1	1	1	0	3
OG0003212	2	0	1	0	3
OG0003213	1	1	1	0	3
OG0003214	1	0	1	1	3
OG0003215	1	0	1	1	3
OG0003216	1	1	1	0	3
OG0003217	1	1	1	0	3
OG0003218	1	1	1	0	3
OG0003219	1	1	1	0	3
OG0003220	1	1	1	0	3
OG0003221	1	1	1	0	3
OG0003222	1	1	1	0	3
OG0003223	1	0	1	1	3
OG0003224	1	1	1	0	3
OG0003225	1	1	1	0	3
OG0003226	1	1	1	0	3
OG0003227	1	1	1	0	3
OG0003228	1	1	1	0	3
OG0003229	1	1	1	0	3
OG0003230	1	1	1	0	3
OG0003231	1	1	1	0	3
OG0003232	1	0	1	1	3
OG0003233	1	0	2	0	3
OG0003234	2	1	0	0	3
OG0003235	1	0	1	1	3
OG0003236	3	0	0	0	3
OG0003237	1	1	1	0	3
OG0003238	1	1	1	0	3
OG0003239	1	1	1	0	3
OG0003240	1	1	1	0	3
OG0003241	1	1	1	0	3
OG0003242	1	0	1	1	3
OG0003243	1	1	1	0	3
OG0003244	1	1	1	0	3
OG0003245	3	0	0	0	3
OG0003246	1	1	1	0	3
OG0003247	1	1	1	0	3
OG0003248	1	1	1	0	3
OG0003249	1	1	1	0	3
OG0003250	1	1	1	0	3
OG0003251	1	1	1	0	3
OG0003252	1	1	1	0	3
OG0003253	1	1	1	0	3
OG0003254	1	0	2	0	3
OG0003255	1	1	1	0	3
OG0003256	3	0	0	0	3
OG0003257	2	1	0	0	3
OG0003258	1	1	1	0	3
OG0003259	1	0	1	1	3
OG0003260	1	0	1	1	3
OG0003261	1	1	0	1	3
OG0003262	1	1	1	0	3
OG0003263	1	1	1	0	3
OG0003264	1	2	0	0	3
OG0003265	1	1	1	0	3
OG0003266	1	1	1	0	3
OG0003267	1	1	0	1	3
OG0003268	1	1	1	0	3
OG0003269	1	0	2	0	3
OG0003270	1	1	1	0	3
OG0003271	1	1	1	0	3
OG0003272	1	1	1	0	3
OG0003273	1	1	0	1	3
OG0003274	1	1	1	0	3
OG0003275	1	1	1	0	3
OG0003276	1	1	1	0	3
OG0003277	1	1	1	0	3
OG0003278	1	1	1	0	3
OG0003279	3	0	0	0	3
OG0003280	1	1	1	0	3
OG0003281	1	1	1	0	3
OG0003282	1	1	1	0	3
OG0003283	1	1	1	0	3
OG0003284	1	1	1	0	3
OG0003285	1	1	1	0	3
OG0003286	1	1	1	0	3
OG0003287	2	1	0	0	3
OG0003288	1	1	1	0	3
OG0003289	1	1	1	0	3
OG0003290	2	0	1	0	3
OG0003291	1	2	0	0	3
OG0003292	1	1	1	0	3
OG0003293	1	2	0	0	3
OG0003294	1	1	1	0	3
OG0003295	1	1	1	0	3
OG0003296	1	1	1	0	3
OG0003297	1	1	1	0	3
OG0003298	1	0	2	0	3
OG0003299	1	0	1	1	3
OG0003300	1	1	1	0	3
OG0003301	1	0	1	1	3
OG0003302	1	1	1	0	3
OG0003303	1	1	1	0	3
OG0003304	1	1	1	0	3
OG0003305	1	0	1	1	3
OG0003306	1	1	1	0	3
OG0003307	3	0	0	0	3
OG0003308	1	1	0	1	3
OG0003309	1	1	1	0	3
OG0003310	1	1	1	0	3
OG0003311	1	1	1	0	3
OG0003312	3	0	0	0	3
OG0003313	1	0	1	1	3
OG0003314	1	1	1	0	3
OG0003315	1	1	1	0	3
OG0003316	1	1	1	0	3
OG0003317	1	1	1	0	3
OG0003318	1	1	1	0	3
OG0003319	1	1	1	0	3
OG0003320	1	1	1	0	3
OG0003321	1	1	1	0	3
OG0003322	1	1	1	0	3
OG0003323	1	1	1	0	3
OG0003324	1	1	1	0	3
OG0003325	1	1	1	0	3
OG0003326	1	0	2	0	3
OG0003327	1	1	1	0	3
OG0003328	1	1	0	1	3
OG0003329	1	1	1	0	3
OG0003330	1	1	1	0	3
OG0003331	1	1	1	0	3
OG0003332	1	1	1	0	3
OG0003333	1	1	1	0	3
OG0003334	1	1	1	0	3
OG0003335	1	1	1	0	3
OG0003336	3	0	0	0	3
OG0003337	1	1	1	0	3
OG0003338	1	1	1	0	3
OG0003339	1	1	1	0	3
OG0003340	3	0	0	0	3
OG0003341	1	1	1	0	3
OG0003342	1	1	1	0	3
OG0003343	1	1	1	0	3
OG0003344	1	1	1	0	3
OG0003345	1	1	1	0	3
OG0003346	1	1	1	0	3
OG0003347	1	1	1	0	3
OG0003348	1	1	1	0	3
OG0003349	1	0	1	1	3
OG0003350	1	0	1	1	3
OG0003351	1	0	2	0	3
OG0003352	3	0	0	0	3
OG0003353	1	1	1	0	3
OG0003354	1	1	1	0	3
OG0003355	1	1	1	0	3
OG0003356	1	1	1	0	3
OG0003357	1	1	1	0	3
OG0003358	1	1	1	0	3
OG0003359	1	0	2	0	3
OG0003360	1	1	1	0	3
OG0003361	1	1	1	0	3
OG0003362	1	1	0	1	3
OG0003363	1	1	1	0	3
OG0003364	1	1	1	0	3
OG0003365	1	0	1	1	3
OG0003366	3	0	0	0	3
OG0003367	1	1	1	0	3
OG0003368	1	1	1	0	3
OG0003369	1	1	1	0	3
OG0003370	1	1	1	0	3
OG0003371	1	1	1	0	3
OG0003372	1	1	1	0	3
OG0003373	1	1	1	0	3
OG0003374	1	2	0	0	3
OG0003375	1	1	1	0	3
OG0003376	1	1	1	0	3
OG0003377	1	1	1	0	3
OG0003378	1	1	1	0	3
OG0003379	1	1	1	0	3
OG0003380	1	1	1	0	3
OG0003381	1	0	2	0	3
OG0003382	1	1	1	0	3
OG0003383	1	1	1	0	3
OG0003384	1	1	1	0	3
OG0003385	1	1	1	0	3
OG0003386	1	0	1	1	3
OG0003387	1	1	1	0	3
OG0003388	1	1	1	0	3
OG0003389	1	1	1	0	3
OG0003390	1	1	1	0	3
OG0003391	1	1	1	0	3
OG0003392	1	1	1	0	3
OG0003393	1	1	1	0	3
OG0003394	1	1	1	0	3
OG0003395	1	1	1	0	3
OG0003396	1	0	1	1	3
OG0003397	1	1	1	0	3
OG0003398	1	1	1	0	3
OG0003399	1	1	0	1	3
OG0003400	1	1	1	0	3
OG0003401	1	1	1	0	3
OG0003402	1	1	1	0	3
OG0003403	1	1	1	0	3
OG0003404	1	1	1	0	3
OG0003405	1	1	1	0	3
OG0003406	1	1	1	0	3
OG0003407	1	1	1	0	3
OG0003408	1	1	1	0	3
OG0003409	1	1	1	0	3
OG0003410	3	0	0	0	3
OG0003411	1	1	1	0	3
OG0003412	3	0	0	0	3
OG0003413	1	1	1	0	3
OG0003414	1	1	1	0	3
OG0003415	1	1	1	0	3
OG0003416	1	1	1	0	3
OG0003417	1	1	1	0	3
OG0003418	1	1	1	0	3
OG0003419	1	1	1	0	3
OG0003420	1	1	1	0	3
OG0003421	1	1	1	0	3
OG0003422	1	1	1	0	3
OG0003423	1	1	1	0	3
OG0003424	1	1	1	0	3
OG0003425	1	1	1	0	3
OG0003426	1	1	1	0	3
OG0003427	1	1	1	0	3
OG0003428	1	1	1	0	3
OG0003429	1	1	1	0	3
OG0003430	1	0	1	1	3
OG0003431	1	0	2	0	3
OG0003432	1	1	1	0	3
OG0003433	1	1	1	0	3
OG0003434	1	1	1	0	3
OG0003435	1	1	1	0	3
OG0003436	1	1	1	0	3
OG0003437	1	1	1	0	3
OG0003438	3	0	0	0	3
OG0003439	1	1	1	0	3
OG0003440	1	1	1	0	3
OG0003441	1	1	1	0	3
OG0003442	1	0	1	1	3
OG0003443	1	1	1	0	3
OG0003444	1	1	1	0	3
OG0003445	1	1	1	0	3
OG0003446	1	1	1	0	3
OG0003447	1	1	1	0	3
OG0003448	1	1	1	0	3
OG0003449	3	0	0	0	3
OG0003450	1	1	1	0	3
OG0003451	1	1	1	0	3
OG0003452	1	1	1	0	3
OG0003453	1	1	1	0	3
OG0003454	1	1	0	1	3
OG0003455	1	1	1	0	3
OG0003456	1	1	1	0	3
OG0003457	1	0	1	1	3
OG0003458	1	1	1	0	3
OG0003459	1	1	1	0	3
OG0003460	1	1	1	0	3
OG0003461	1	0	1	1	3
OG0003462	1	1	1	0	3
OG0003463	1	1	1	0	3
OG0003464	1	0	2	0	3
OG0003465	1	1	1	0	3
OG0003466	1	1	1	0	3
OG0003467	1	0	1	1	3
OG0003468	1	1	1	0	3
OG0003469	3	0	0	0	3
OG0003470	3	0	0	0	3
OG0003471	3	0	0	0	3
OG0003472	3	0	0	0	3
OG0003473	1	1	1	0	3
OG0003474	3	0	0	0	3
OG0003475	1	1	1	0	3
OG0003476	1	1	1	0	3
OG0003477	3	0	0	0	3
OG0003478	1	1	1	0	3
OG0003479	1	1	1	0	3
OG0003480	1	1	1	0	3
OG0003481	1	1	1	0	3
OG0003482	1	1	1	0	3
OG0003483	1	0	2	0	3
OG0003484	1	0	1	1	3
OG0003485	1	1	1	0	3
OG0003486	1	0	2	0	3
OG0003487	1	1	1	0	3
OG0003488	1	1	1	0	3
OG0003489	1	1	1	0	3
OG0003490	1	1	1	0	3
OG0003491	1	1	1	0	3
OG0003492	1	1	1	0	3
OG0003493	1	1	1	0	3
OG0003494	1	1	1	0	3
OG0003495	1	1	1	0	3
OG0003496	1	1	1	0	3
OG0003497	1	1	1	0	3
OG0003498	1	0	2	0	3
OG0003499	1	1	1	0	3
OG0003500	1	1	1	0	3
OG0003501	1	1	1	0	3
OG0003502	3	0	0	0	3
OG0003503	1	1	0	1	3
OG0003504	1	1	1	0	3
OG0003505	1	2	0	0	3
OG0003506	1	1	1	0	3
OG0003507	1	1	1	0	3
OG0003508	1	1	1	0	3
OG0003509	1	1	1	0	3
OG0003510	1	1	1	0	3
OG0003511	2	1	0	0	3
OG0003512	1	1	1	0	3
OG0003513	1	1	1	0	3
OG0003514	1	0	1	1	3
OG0003515	1	1	1	0	3
OG0003516	2	0	1	0	3
OG0003517	1	1	1	0	3
OG0003518	1	1	1	0	3
OG0003519	1	1	0	1	3
OG0003520	1	1	1	0	3
OG0003521	1	1	1	0	3
OG0003522	1	1	1	0	3
OG0003523	1	1	1	0	3
OG0003524	1	0	2	0	3
OG0003525	1	1	1	0	3
OG0003526	1	1	1	0	3
OG0003527	1	0	1	1	3
OG0003528	1	1	1	0	3
OG0003529	1	1	1	0	3
OG0003530	1	1	1	0	3
OG0003531	1	2	0	0	3
OG0003532	1	1	1	0	3
OG0003533	1	1	1	0	3
OG0003534	1	2	0	0	3
OG0003535	1	1	1	0	3
OG0003536	1	1	1	0	3
OG0003537	1	1	1	0	3
OG0003538	1	1	1	0	3
OG0003539	1	1	1	0	3
OG0003540	2	0	1	0	3
OG0003541	1	1	1	0	3
OG0003542	1	0	1	1	3
OG0003543	1	1	1	0	3
OG0003544	1	1	1	0	3
OG0003545	1	1	1	0	3
OG0003546	1	1	1	0	3
OG0003547	1	1	1	0	3
OG0003548	3	0	0	0	3
OG0003549	2	1	0	0	3
OG0003550	1	1	0	1	3
OG0003551	3	0	0	0	3
OG0003552	1	1	1	0	3
OG0003553	1	1	1	0	3
OG0003554	1	1	1	0	3
OG0003555	1	1	1	0	3
OG0003556	1	0	2	0	3
OG0003557	1	1	1	0	3
OG0003558	2	0	1	0	3
OG0003559	1	1	1	0	3
OG0003560	1	1	1	0	3
OG0003561	1	1	1	0	3
OG0003562	1	1	1	0	3
OG0003563	1	1	1	0	3
OG0003564	1	1	1	0	3
OG0003565	1	1	1	0	3
OG0003566	1	1	1	0	3
OG0003567	1	1	1	0	3
OG0003568	1	1	1	0	3
OG0003569	3	0	0	0	3
OG0003570	1	0	1	1	3
OG0003571	2	0	1	0	3
OG0003572	2	0	1	0	3
OG0003573	1	1	0	1	3
OG0003574	1	1	1	0	3
OG0003575	1	1	1	0	3
OG0003576	1	1	1	0	3
OG0003577	2	0	1	0	3
OG0003578	1	1	1	0	3
OG0003579	1	1	1	0	3
OG0003580	1	0	2	0	3
OG0003581	3	0	0	0	3
OG0003582	1	0	1	1	3
OG0003583	1	1	1	0	3
OG0003584	1	1	1	0	3
OG0003585	1	1	1	0	3
OG0003586	1	1	1	0	3
OG0003587	1	1	1	0	3
OG0003588	1	1	1	0	3
OG0003589	1	2	0	0	3
OG0003590	1	1	1	0	3
OG0003591	1	1	1	0	3
OG0003592	1	1	0	1	3
OG0003593	1	1	1	0	3
OG0003594	1	1	1	0	3
OG0003595	1	1	1	0	3
OG0003596	1	1	1	0	3
OG0003597	1	2	0	0	3
OG0003598	1	1	1	0	3
OG0003599	1	1	1	0	3
OG0003600	1	1	1	0	3
OG0003601	2	0	1	0	3
OG0003602	1	1	1	0	3
OG0003603	1	1	1	0	3
OG0003604	1	1	1	0	3
OG0003605	1	1	1	0	3
OG0003606	1	1	1	0	3
OG0003607	1	0	1	1	3
OG0003608	1	1	1	0	3
OG0003609	1	0	1	1	3
OG0003610	1	1	1	0	3
OG0003611	1	1	1	0	3
OG0003612	1	1	1	0	3
OG0003613	1	1	1	0	3
OG0003614	1	1	1	0	3
OG0003615	1	1	1	0	3
OG0003616	1	0	1	1	3
OG0003617	1	1	1	0	3
OG0003618	1	1	1	0	3
OG0003619	1	1	1	0	3
OG0003620	1	1	1	0	3
OG0003621	1	1	1	0	3
OG0003622	1	1	1	0	3
OG0003623	1	1	1	0	3
OG0003624	1	1	1	0	3
OG0003625	1	1	1	0	3
OG0003626	3	0	0	0	3
OG0003627	1	1	1	0	3
OG0003628	1	1	1	0	3
OG0003629	1	1	1	0	3
OG0003630	1	1	0	1	3
OG0003631	1	1	0	1	3
OG0003632	1	1	1	0	3
OG0003633	1	1	1	0	3
OG0003634	1	0	1	1	3
OG0003635	1	1	1	0	3
OG0003636	1	1	1	0	3
OG0003637	3	0	0	0	3
OG0003638	3	0	0	0	3
OG0003639	1	1	1	0	3
OG0003640	1	1	1	0	3
OG0003641	1	1	1	0	3
OG0003642	1	1	1	0	3
OG0003643	1	1	1	0	3
OG0003644	1	1	1	0	3
OG0003645	1	1	0	1	3
OG0003646	1	1	1	0	3
OG0003647	1	1	1	0	3
OG0003648	1	0	2	0	3
OG0003649	1	1	1	0	3
OG0003650	1	0	2	0	3
OG0003651	1	1	1	0	3
OG0003652	2	1	0	0	3
OG0003653	1	1	1	0	3
OG0003654	1	1	1	0	3
OG0003655	1	1	1	0	3
OG0003656	2	0	1	0	3
OG0003657	1	1	1	0	3
OG0003658	1	1	1	0	3
OG0003659	1	1	1	0	3
OG0003660	1	1	1	0	3
OG0003661	1	1	1	0	3
OG0003662	1	0	0	2	3
OG0003663	1	1	1	0	3
OG0003664	1	1	1	0	3
OG0003665	1	1	1	0	3
OG0003666	1	1	1	0	3
OG0003667	1	1	1	0	3
OG0003668	1	1	1	0	3
OG0003669	1	1	1	0	3
OG0003670	1	2	0	0	3
OG0003671	1	1	1	0	3
OG0003672	1	0	1	1	3
OG0003673	1	1	1	0	3
OG0003674	1	1	1	0	3
OG0003675	1	1	1	0	3
OG0003676	1	1	1	0	3
OG0003677	1	1	1	0	3
OG0003678	1	1	1	0	3
OG0003679	1	1	1	0	3
OG0003680	1	1	1	0	3
OG0003681	1	1	1	0	3
OG0003682	1	1	1	0	3
OG0003683	1	1	1	0	3
OG0003684	1	1	1	0	3
OG0003685	1	1	1	0	3
OG0003686	1	1	1	0	3
OG0003687	1	1	1	0	3
OG0003688	1	1	1	0	3
OG0003689	1	1	1	0	3
OG0003690	1	1	1	0	3
OG0003691	1	1	1	0	3
OG0003692	1	1	1	0	3
OG0003693	1	2	0	0	3
OG0003694	1	1	1	0	3
OG0003695	1	1	1	0	3
OG0003696	1	1	1	0	3
OG0003697	3	0	0	0	3
OG0003698	1	1	1	0	3
OG0003699	3	0	0	0	3
OG0003700	1	1	1	0	3
OG0003701	1	0	2	0	3
OG0003702	1	1	1	0	3
OG0003703	1	1	1	0	3
OG0003704	1	1	1	0	3
OG0003705	1	0	1	1	3
OG0003706	1	1	1	0	3
OG0003707	1	1	1	0	3
OG0003708	1	1	1	0	3
OG0003709	1	1	1	0	3
OG0003710	1	1	1	0	3
OG0003711	1	1	1	0	3
OG0003712	1	1	1	0	3
OG0003713	1	1	1	0	3
OG0003714	1	1	1	0	3
OG0003715	1	1	1	0	3
OG0003716	1	1	1	0	3
OG0003717	1	1	1	0	3
OG0003718	1	1	1	0	3
OG0003719	1	1	1	0	3
OG0003720	1	1	1	0	3
OG0003721	1	1	1	0	3
OG0003722	1	0	0	2	3
OG0003723	1	1	1	0	3
OG0003724	1	0	1	1	3
OG0003725	1	1	1	0	3
OG0003726	1	0	1	1	3
OG0003727	1	1	1	0	3
OG0003728	1	1	1	0	3
OG0003729	1	1	1	0	3
OG0003730	1	1	1	0	3
OG0003731	1	1	1	0	3
OG0003732	1	1	0	1	3
OG0003733	1	1	1	0	3
OG0003734	1	1	1	0	3
OG0003735	1	1	1	0	3
OG0003736	1	1	1	0	3
OG0003737	1	1	1	0	3
OG0003738	1	1	1	0	3
OG0003739	3	0	0	0	3
OG0003740	3	0	0	0	3
OG0003741	1	1	1	0	3
OG0003742	1	1	1	0	3
OG0003743	1	1	0	1	3
OG0003744	1	1	1	0	3
OG0003745	1	1	0	1	3
OG0003746	1	1	1	0	3
OG0003747	1	1	1	0	3
OG0003748	1	1	1	0	3
OG0003749	1	1	1	0	3
OG0003750	1	1	1	0	3
OG0003751	1	1	0	1	3
OG0003752	1	1	0	1	3
OG0003753	1	1	1	0	3
OG0003754	1	1	1	0	3
OG0003755	3	0	0	0	3
OG0003756	1	1	1	0	3
OG0003757	1	1	1	0	3
OG0003758	1	1	1	0	3
OG0003759	1	1	1	0	3
OG0003760	1	1	0	1	3
OG0003761	1	1	1	0	3
OG0003762	1	1	1	0	3
OG0003763	1	1	1	0	3
OG0003764	1	1	1	0	3
OG0003765	1	1	1	0	3
OG0003766	1	1	1	0	3
OG0003767	1	1	1	0	3
OG0003768	1	1	1	0	3
OG0003769	1	1	1	0	3
OG0003770	1	1	1	0	3
OG0003771	1	1	1	0	3
OG0003772	1	1	1	0	3
OG0003773	1	1	1	0	3
OG0003774	1	1	1	0	3
OG0003775	2	0	1	0	3
OG0003776	2	0	1	0	3
OG0003777	1	0	1	1	3
OG0003778	1	1	1	0	3
OG0003779	3	0	0	0	3
OG0003780	1	1	1	0	3
OG0003781	1	1	1	0	3
OG0003782	1	1	1	0	3
OG0003783	1	1	1	0	3
OG0003784	1	1	1	0	3
OG0003785	1	1	1	0	3
OG0003786	1	1	1	0	3
OG0003787	1	1	1	0	3
OG0003788	1	1	1	0	3
OG0003789	1	1	0	1	3
OG0003790	1	1	1	0	3
OG0003791	1	1	1	0	3
OG0003792	1	1	1	0	3
OG0003793	1	1	0	1	3
OG0003794	1	1	1	0	3
OG0003795	1	1	1	0	3
OG0003796	1	1	1	0	3
OG0003797	1	2	0	0	3
OG0003798	1	1	1	0	3
OG0003799	1	1	1	0	3
OG0003800	1	1	1	0	3
OG0003801	1	1	1	0	3
OG0003802	1	1	1	0	3
OG0003803	1	1	1	0	3
OG0003804	1	1	1	0	3
OG0003805	1	1	1	0	3
OG0003806	1	0	1	1	3
OG0003807	2	1	0	0	3
OG0003808	1	1	1	0	3
OG0003809	1	1	1	0	3
OG0003810	1	1	1	0	3
OG0003811	1	1	1	0	3
OG0003812	1	2	0	0	3
OG0003813	2	0	1	0	3
OG0003814	1	1	1	0	3
OG0003815	1	1	1	0	3
OG0003816	1	1	1	0	3
OG0003817	3	0	0	0	3
OG0003818	1	1	1	0	3
OG0003819	1	1	0	1	3
OG0003820	1	0	1	1	3
OG0003821	1	1	0	1	3
OG0003822	1	1	1	0	3
OG0003823	1	1	1	0	3
OG0003824	1	1	1	0	3
OG0003825	1	1	1	0	3
OG0003826	1	1	1	0	3
OG0003827	1	1	1	0	3
OG0003828	3	0	0	0	3
OG0003829	1	1	1	0	3
OG0003830	1	1	1	0	3
OG0003831	1	1	1	0	3
OG0003832	1	0	2	0	3
OG0003833	1	1	1	0	3
OG0003834	3	0	0	0	3
OG0003835	1	1	1	0	3
OG0003836	1	1	1	0	3
OG0003837	1	1	1	0	3
OG0003838	1	2	0	0	3
OG0003839	1	1	1	0	3
OG0003840	1	1	1	0	3
OG0003841	1	1	1	0	3
OG0003842	1	1	1	0	3
OG0003843	1	1	1	0	3
OG0003844	1	0	2	0	3
OG0003845	1	1	1	0	3
OG0003846	1	1	1	0	3
OG0003847	1	1	1	0	3
OG0003848	1	1	1	0	3
OG0003849	1	1	1	0	3
OG0003850	1	1	1	0	3
OG0003851	1	0	1	1	3
OG0003852	1	1	0	1	3
OG0003853	1	1	1	0	3
OG0003854	1	1	1	0	3
OG0003855	1	1	1	0	3
OG0003856	1	1	1	0	3
OG0003857	1	1	1	0	3
OG0003858	1	1	1	0	3
OG0003859	1	1	1	0	3
OG0003860	1	1	1	0	3
OG0003861	1	0	1	1	3
OG0003862	1	0	1	1	3
OG0003863	1	1	1	0	3
OG0003864	1	1	1	0	3
OG0003865	1	1	1	0	3
OG0003866	1	1	1	0	3
OG0003867	1	1	1	0	3
OG0003868	1	1	1	0	3
OG0003869	1	0	2	0	3
OG0003870	1	1	1	0	3
OG0003871	1	1	1	0	3
OG0003872	1	1	1	0	3
OG0003873	1	1	1	0	3
OG0003874	1	1	1	0	3
OG0003875	1	1	1	0	3
OG0003876	1	1	1	0	3
OG0003877	1	1	1	0	3
OG0003878	1	1	1	0	3
OG0003879	1	1	1	0	3
OG0003880	1	1	1	0	3
OG0003881	1	1	1	0	3
OG0003882	1	1	1	0	3
OG0003883	1	1	1	0	3
OG0003884	1	1	1	0	3
OG0003885	1	1	1	0	3
OG0003886	1	1	0	1	3
OG0003887	2	0	1	0	3
OG0003888	1	1	1	0	3
OG0003889	1	1	1	0	3
OG0003890	1	1	1	0	3
OG0003891	1	0	1	1	3
OG0003892	1	1	1	0	3
OG0003893	1	1	1	0	3
OG0003894	1	1	1	0	3
OG0003895	1	1	1	0	3
OG0003896	1	1	1	0	3
OG0003897	1	0	1	1	3
OG0003898	1	1	1	0	3
OG0003899	1	1	1	0	3
OG0003900	1	1	1	0	3
OG0003901	1	1	1	0	3
OG0003902	1	1	1	0	3
OG0003903	1	1	1	0	3
OG0003904	1	1	1	0	3
OG0003905	1	0	1	1	3
OG0003906	1	1	1	0	3
OG0003907	1	1	1	0	3
OG0003908	1	1	1	0	3
OG0003909	1	1	1	0	3
OG0003910	1	1	1	0	3
OG0003911	1	1	1	0	3
OG0003912	1	1	1	0	3
OG0003913	1	1	1	0	3
OG0003914	1	0	2	0	3
OG0003915	1	1	1	0	3
OG0003916	1	1	1	0	3
OG0003917	1	1	1	0	3
OG0003918	1	1	1	0	3
OG0003919	1	1	1	0	3
OG0003920	1	1	1	0	3
OG0003921	1	1	1	0	3
OG0003922	1	1	0	1	3
OG0003923	1	1	1	0	3
OG0003924	1	1	1	0	3
OG0003925	1	1	1	0	3
OG0003926	1	1	1	0	3
OG0003927	1	1	1	0	3
OG0003928	1	2	0	0	3
OG0003929	1	1	0	1	3
OG0003930	1	0	1	1	3
OG0003931	1	1	1	0	3
OG0003932	1	1	0	1	3
OG0003933	1	1	1	0	3
OG0003934	1	1	1	0	3
OG0003935	1	1	1	0	3
OG0003936	1	1	1	0	3
OG0003937	1	0	1	1	3
OG0003938	1	1	1	0	3
OG0003939	1	1	1	0	3
OG0003940	1	1	1	0	3
OG0003941	1	1	1	0	3
OG0003942	1	0	1	1	3
OG0003943	1	1	1	0	3
OG0003944	1	0	1	1	3
OG0003945	1	1	1	0	3
OG0003946	1	1	1	0	3
OG0003947	1	1	1	0	3
OG0003948	1	1	1	0	3
OG0003949	1	1	1	0	3
OG0003950	1	1	1	0	3
OG0003951	1	1	1	0	3
OG0003952	1	1	1	0	3
OG0003953	1	1	1	0	3
OG0003954	1	1	1	0	3
OG0003955	1	1	1	0	3
OG0003956	1	1	1	0	3
OG0003957	1	1	1	0	3
OG0003958	1	1	1	0	3
OG0003959	1	1	1	0	3
OG0003960	3	0	0	0	3
OG0003961	1	1	1	0	3
OG0003962	1	1	1	0	3
OG0003963	1	1	1	0	3
OG0003964	2	0	1	0	3
OG0003965	1	1	1	0	3
OG0003966	1	1	1	0	3
OG0003967	1	1	1	0	3
OG0003968	1	1	1	0	3
OG0003969	1	1	1	0	3
OG0003970	1	1	1	0	3
OG0003971	1	1	1	0	3
OG0003972	1	1	1	0	3
OG0003973	1	1	1	0	3
OG0003974	1	1	1	0	3
OG0003975	1	0	1	1	3
OG0003976	1	1	1	0	3
OG0003977	1	1	1	0	3
OG0003978	1	1	1	0	3
OG0003979	1	1	1	0	3
OG0003980	1	1	1	0	3
OG0003981	1	1	1	0	3
OG0003982	1	1	0	1	3
OG0003983	1	1	1	0	3
OG0003984	1	1	1	0	3
OG0003985	1	1	1	0	3
OG0003986	1	1	0	1	3
OG0003987	1	0	2	0	3
OG0003988	1	1	1	0	3
OG0003989	1	0	1	1	3
OG0003990	1	1	1	0	3
OG0003991	1	0	2	0	3
OG0003992	1	1	1	0	3
OG0003993	1	1	1	0	3
OG0003994	1	0	1	1	3
OG0003995	1	1	1	0	3
OG0003996	1	1	1	0	3
OG0003997	1	1	1	0	3
OG0003998	1	0	2	0	3
OG0003999	3	0	0	0	3
OG0004000	1	1	1	0	3
OG0004001	1	0	0	2	3
OG0004002	1	1	1	0	3
OG0004003	1	1	1	0	3
OG0004004	1	1	1	0	3
OG0004005	1	1	1	0	3
OG0004006	1	1	1	0	3
OG0004007	1	1	1	0	3
OG0004008	1	1	1	0	3
OG0004009	1	1	0	1	3
OG0004010	1	0	2	0	3
OG0004011	1	1	1	0	3
OG0004012	1	1	1	0	3
OG0004013	1	1	1	0	3
OG0004014	1	1	1	0	3
OG0004015	1	1	1	0	3
OG0004016	1	1	1	0	3
OG0004017	1	1	1	0	3
OG0004018	1	1	1	0	3
OG0004019	1	1	1	0	3
OG0004020	1	1	1	0	3
OG0004021	1	0	1	1	3
OG0004022	1	1	1	0	3
OG0004023	1	1	1	0	3
OG0004024	1	1	1	0	3
OG0004025	1	1	1	0	3
OG0004026	1	1	1	0	3
OG0004027	1	1	1	0	3
OG0004028	1	1	1	0	3
OG0004029	1	1	1	0	3
OG0004030	1	1	1	0	3
OG0004031	1	1	1	0	3
OG0004032	3	0	0	0	3
OG0004033	3	0	0	0	3
OG0004034	1	1	1	0	3
OG0004035	1	1	1	0	3
OG0004036	1	1	1	0	3
OG0004037	1	1	1	0	3
OG0004038	3	0	0	0	3
OG0004039	3	0	0	0	3
OG0004040	1	1	1	0	3
OG0004041	1	1	1	0	3
OG0004042	1	1	1	0	3
OG0004043	1	1	1	0	3
OG0004044	1	1	1	0	3
OG0004045	1	1	1	0	3
OG0004046	1	0	1	1	3
OG0004047	1	1	1	0	3
OG0004048	1	1	1	0	3
OG0004049	1	1	1	0	3
OG0004050	1	0	1	1	3
OG0004051	1	1	1	0	3
OG0004052	1	1	1	0	3
OG0004053	1	1	1	0	3
OG0004054	1	1	1	0	3
OG0004055	1	1	1	0	3
OG0004056	1	1	1	0	3
OG0004057	1	1	1	0	3
OG0004058	1	1	1	0	3
OG0004059	1	1	0	1	3
OG0004060	1	1	1	0	3
OG0004061	1	1	1	0	3
OG0004062	1	0	2	0	3
OG0004063	1	1	1	0	3
OG0004064	1	1	1	0	3
OG0004065	1	1	1	0	3
OG0004066	1	1	1	0	3
OG0004067	1	1	0	1	3
OG0004068	1	1	1	0	3
OG0004069	1	1	1	0	3
OG0004070	1	1	1	0	3
OG0004071	1	2	0	0	3
OG0004072	1	1	1	0	3
OG0004073	1	1	1	0	3
OG0004074	1	0	1	1	3
OG0004075	1	1	1	0	3
OG0004076	1	1	1	0	3
OG0004077	1	0	2	0	3
OG0004078	1	1	1	0	3
OG0004079	1	1	1	0	3
OG0004080	1	1	1	0	3
OG0004081	1	1	1	0	3
OG0004082	1	1	1	0	3
OG0004083	1	1	1	0	3
OG0004084	0	3	0	0	3
OG0004085	0	1	1	1	3
OG0004086	0	3	0	0	3
OG0004087	0	1	2	0	3
OG0004088	0	3	0	0	3
OG0004089	0	3	0	0	3
OG0004090	0	3	0	0	3
OG0004091	0	1	1	1	3
OG0004092	0	3	0	0	3
OG0004093	0	3	0	0	3
OG0004094	0	1	1	1	3
OG0004095	0	2	1	0	3
OG0004096	0	1	1	1	3
OG0004097	0	3	0	0	3
OG0004098	0	3	0	0	3
OG0004099	0	3	0	0	3
OG0004100	0	1	1	1	3
OG0004101	0	1	1	1	3
OG0004102	0	3	0	0	3
OG0004103	0	2	1	0	3
OG0004104	0	1	1	1	3
OG0004105	0	1	1	1	3
OG0004106	0	1	1	1	3
OG0004107	0	1	1	1	3
OG0004108	0	3	0	0	3
OG0004109	0	3	0	0	3
OG0004110	0	1	1	1	3
OG0004111	0	1	1	1	3
OG0004112	0	3	0	0	3
OG0004113	0	3	0	0	3
OG0004114	0	3	0	0	3
OG0004115	0	1	2	0	3
OG0004116	0	1	2	0	3
OG0004117	0	3	0	0	3
OG0004118	0	3	0	0	3
OG0004119	0	1	2	0	3
OG0004120	0	1	1	1	3
OG0004121	0	2	1	0	3
OG0004122	0	1	1	1	3
OG0004123	0	3	0	0	3
OG0004124	0	1	1	1	3
OG0004125	0	1	1	1	3
OG0004126	0	3	0	0	3
OG0004127	0	1	0	2	3
OG0004128	0	2	1	0	3
OG0004129	0	1	1	1	3
OG0004130	0	1	0	2	3
OG0004131	0	1	2	0	3
OG0004132	0	2	1	0	3
OG0004133	0	1	2	0	3
OG0004134	0	2	1	0	3
OG0004135	0	3	0	0	3
OG0004136	0	3	0	0	3
OG0004137	0	3	0	0	3
OG0004138	0	1	2	0	3
OG0004139	0	1	1	1	3
OG0004140	0	3	0	0	3
OG0004141	0	1	1	1	3
OG0004142	0	1	1	1	3
OG0004143	0	2	1	0	3
OG0004144	0	1	1	1	3
OG0004145	0	1	1	1	3
OG0004146	0	1	1	1	3
OG0004147	0	1	1	1	3
OG0004148	0	3	0	0	3
OG0004149	0	1	2	0	3
OG0004150	0	1	1	1	3
OG0004151	0	1	2	0	3
OG0004152	0	3	0	0	3
OG0004153	0	1	1	1	3
OG0004154	0	1	1	1	3
OG0004155	0	1	1	1	3
OG0004156	0	1	1	1	3
OG0004157	0	1	2	0	3
OG0004158	0	1	1	1	3
OG0004159	0	2	0	1	3
OG0004160	0	3	0	0	3
OG0004161	0	3	0	0	3
OG0004162	0	2	1	0	3
OG0004163	0	3	0	0	3
OG0004164	0	1	2	0	3
OG0004165	0	2	1	0	3
OG0004166	0	1	1	1	3
OG0004167	0	3	0	0	3
OG0004168	0	2	1	0	3
OG0004169	0	1	1	1	3
OG0004170	0	3	0	0	3
OG0004171	0	3	0	0	3
OG0004172	0	3	0	0	3
OG0004173	0	3	0	0	3
OG0004174	0	3	0	0	3
OG0004175	0	2	0	1	3
OG0004176	0	2	1	0	3
OG0004177	0	1	1	1	3
OG0004178	0	3	0	0	3
OG0004179	0	1	1	1	3
OG0004180	0	3	0	0	3
OG0004181	0	1	2	0	3
OG0004182	0	1	2	0	3
OG0004183	0	2	1	0	3
OG0004184	0	3	0	0	3
OG0004185	0	3	0	0	3
OG0004186	0	3	0	0	3
OG0004187	0	3	0	0	3
OG0004188	0	3	0	0	3
OG0004189	0	1	2	0	3
OG0004190	0	1	0	2	3
OG0004191	0	1	1	1	3
OG0004192	0	2	1	0	3
OG0004193	0	2	1	0	3
OG0004194	0	1	2	0	3
OG0004195	0	1	2	0	3
OG0004196	0	3	0	0	3
OG0004197	0	1	2	0	3
OG0004198	0	1	2	0	3
OG0004199	0	1	1	1	3
OG0004200	0	1	2	0	3
OG0004201	0	3	0	0	3
OG0004202	0	2	1	0	3
OG0004203	0	1	1	1	3
OG0004204	0	3	0	0	3
OG0004205	0	3	0	0	3
OG0004206	0	3	0	0	3
OG0004207	0	3	0	0	3
OG0004208	0	1	1	1	3
OG0004209	0	3	0	0	3
OG0004210	0	3	0	0	3
OG0004211	0	3	0	0	3
OG0004212	0	3	0	0	3
OG0004213	0	1	1	1	3
OG0004214	0	3	0	0	3
OG0004215	0	3	0	0	3
OG0004216	0	3	0	0	3
OG0004217	0	1	1	1	3
OG0004218	0	3	0	0	3
OG0004219	0	2	1	0	3
OG0004220	0	1	1	1	3
OG0004221	0	1	1	1	3
OG0004222	0	2	1	0	3
OG0004223	0	3	0	0	3
OG0004224	0	1	2	0	3
OG0004225	0	2	1	0	3
OG0004226	0	2	1	0	3
OG0004227	0	1	1	1	3
OG0004228	0	3	0	0	3
OG0004229	0	3	0	0	3
OG0004230	0	2	1	0	3
OG0004231	0	1	1	1	3
OG0004232	0	1	2	0	3
OG0004233	0	1	2	0	3
OG0004234	0	1	1	1	3
OG0004235	0	1	2	0	3
OG0004236	0	2	1	0	3
OG0004237	0	1	2	0	3
OG0004238	0	1	1	1	3
OG0004239	0	1	1	1	3
OG0004240	0	1	2	0	3
OG0004241	0	2	1	0	3
OG0004242	0	3	0	0	3
OG0004243	0	1	1	1	3
OG0004244	0	2	1	0	3
OG0004245	0	1	2	0	3
OG0004246	0	3	0	0	3
OG0004247	0	1	2	0	3
OG0004248	0	3	0	0	3
OG0004249	0	1	2	0	3
OG0004250	0	1	1	1	3
OG0004251	0	1	1	1	3
OG0004252	0	3	0	0	3
OG0004253	0	1	1	1	3
OG0004254	0	2	0	1	3
OG0004255	0	2	1	0	3
OG0004256	0	1	2	0	3
OG0004257	0	1	2	0	3
OG0004258	0	3	0	0	3
OG0004259	0	1	0	2	3
OG0004260	0	1	1	1	3
OG0004261	0	1	1	1	3
OG0004262	0	2	1	0	3
OG0004263	0	1	1	1	3
OG0004264	0	1	1	1	3
OG0004265	0	1	1	1	3
OG0004266	0	2	1	0	3
OG0004267	0	2	1	0	3
OG0004268	0	3	0	0	3
OG0004269	0	3	0	0	3
OG0004270	0	3	0	0	3
OG0004271	0	1	2	0	3
OG0004272	0	1	1	1	3
OG0004273	0	1	1	1	3
OG0004274	0	1	1	1	3
OG0004275	0	1	1	1	3
OG0004276	0	1	2	0	3
OG0004277	0	2	1	0	3
OG0004278	0	2	1	0	3
OG0004279	0	3	0	0	3
OG0004280	0	1	1	1	3
OG0004281	0	3	0	0	3
OG0004282	0	1	1	1	3
OG0004283	0	3	0	0	3
OG0004284	0	1	1	1	3
OG0004285	0	1	2	0	3
OG0004286	0	1	1	1	3
OG0004287	0	1	1	1	3
OG0004288	0	1	1	1	3
OG0004289	0	3	0	0	3
OG0004290	0	3	0	0	3
OG0004291	0	1	2	0	3
OG0004292	0	2	0	1	3
OG0004293	0	1	2	0	3
OG0004294	0	3	0	0	3
OG0004295	0	3	0	0	3
OG0004296	0	1	1	1	3
OG0004297	0	3	0	0	3
OG0004298	0	3	0	0	3
OG0004299	0	1	1	1	3
OG0004300	0	1	1	1	3
OG0004301	0	2	1	0	3
OG0004302	0	1	1	1	3
OG0004303	0	1	1	1	3
OG0004304	0	2	1	0	3
OG0004305	0	1	1	1	3
OG0004306	0	1	1	1	3
OG0004307	0	1	1	1	3
OG0004308	0	1	1	1	3
OG0004309	0	1	1	1	3
OG0004310	0	1	1	1	3
OG0004311	0	1	1	1	3
OG0004312	0	1	1	1	3
OG0004313	0	1	1	1	3
OG0004314	0	1	2	0	3
OG0004315	0	3	0	0	3
OG0004316	0	2	1	0	3
OG0004317	0	3	0	0	3
OG0004318	0	3	0	0	3
OG0004319	0	2	1	0	3
OG0004320	0	2	1	0	3
OG0004321	0	1	2	0	3
OG0004322	0	3	0	0	3
OG0004323	0	3	0	0	3
OG0004324	0	2	1	0	3
OG0004325	0	2	1	0	3
OG0004326	0	1	2	0	3
OG0004327	0	3	0	0	3
OG0004328	0	3	0	0	3
OG0004329	0	1	2	0	3
OG0004330	0	3	0	0	3
OG0004331	0	3	0	0	3
OG0004332	0	3	0	0	3
OG0004333	0	3	0	0	3
OG0004334	0	3	0	0	3
OG0004335	0	3	0	0	3
OG0004336	0	1	2	0	3
OG0004337	0	1	2	0	3
OG0004338	0	2	1	0	3
OG0004339	0	1	1	1	3
OG0004340	0	2	1	0	3
OG0004341	0	3	0	0	3
OG0004342	0	3	0	0	3
OG0004343	0	1	1	1	3
OG0004344	0	3	0	0	3
OG0004345	0	1	2	0	3
OG0004346	0	1	1	1	3
OG0004347	0	3	0	0	3
OG0004348	0	1	2	0	3
OG0004349	0	1	1	1	3
OG0004350	0	2	1	0	3
OG0004351	0	1	1	1	3
OG0004352	0	1	1	1	3
OG0004353	0	3	0	0	3
OG0004354	0	3	0	0	3
OG0004355	0	1	2	0	3
OG0004356	0	1	1	1	3
OG0004357	0	1	1	1	3
OG0004358	0	1	1	1	3
OG0004359	0	1	1	1	3
OG0004360	0	1	1	1	3
OG0004361	0	1	2	0	3
OG0004362	0	1	1	1	3
OG0004363	0	1	1	1	3
OG0004364	0	2	1	0	3
OG0004365	0	1	2	0	3
OG0004366	0	2	1	0	3
OG0004367	0	1	2	0	3
OG0004368	0	2	1	0	3
OG0004369	0	3	0	0	3
OG0004370	0	1	2	0	3
OG0004371	0	3	0	0	3
OG0004372	0	1	2	0	3
OG0004373	0	3	0	0	3
OG0004374	0	1	1	1	3
OG0004375	0	1	2	0	3
OG0004376	0	1	2	0	3
OG0004377	0	1	2	0	3
OG0004378	0	3	0	0	3
OG0004379	0	2	1	0	3
OG0004380	0	2	1	0	3
OG0004381	0	1	2	0	3
OG0004382	0	1	2	0	3
OG0004383	0	2	1	0	3
OG0004384	0	3	0	0	3
OG0004385	0	3	0	0	3
OG0004386	0	1	2	0	3
OG0004387	0	2	1	0	3
OG0004388	0	2	1	0	3
OG0004389	0	0	3	0	3
OG0004390	0	0	3	0	3
OG0004391	0	0	3	0	3
OG0004392	0	0	2	1	3
OG0004393	0	0	3	0	3
OG0004394	0	0	3	0	3
OG0004395	0	0	1	2	3
OG0004396	0	0	3	0	3
OG0004397	0	0	3	0	3
OG0004398	0	0	3	0	3
OG0004399	0	0	2	1	3
OG0004400	0	0	3	0	3
OG0004401	0	0	3	0	3
OG0004402	0	0	1	2	3
OG0004403	0	0	3	0	3
OG0004404	0	0	3	0	3
OG0004405	0	0	1	2	3
OG0004406	0	0	3	0	3
OG0004407	0	0	3	0	3
OG0004408	0	0	3	0	3
OG0004409	0	0	1	2	3
OG0004410	0	0	3	0	3
OG0004411	0	0	3	0	3
OG0004412	0	0	1	2	3
OG0004413	0	0	3	0	3
OG0004414	0	0	3	0	3
OG0004415	0	0	1	2	3
OG0004416	0	0	3	0	3
OG0004417	0	0	3	0	3
OG0004418	0	0	3	0	3
OG0004419	0	0	3	0	3
OG0004420	0	0	3	0	3
OG0004421	0	0	3	0	3
OG0004422	0	0	3	0	3
OG0004423	0	0	3	0	3
OG0004424	0	0	3	0	3
OG0004425	0	0	3	0	3
OG0004426	0	0	3	0	3
OG0004427	0	0	2	1	3
OG0004428	0	0	1	2	3
OG0004429	0	0	1	2	3
OG0004430	0	0	0	3	3
OG0004431	0	0	0	3	3
OG0004432	0	0	0	3	3
OG0004433	0	0	0	3	3
OG0004434	0	0	0	3	3
OG0004435	0	0	0	3	3
OG0004436	0	0	0	3	3
OG0004437	0	0	0	3	3
OG0004438	0	0	0	3	3
OG0004439	0	0	0	3	3
OG0004440	0	0	0	3	3
OG0004441	0	0	0	3	3
OG0004442	0	0	0	3	3
OG0004443	0	0	0	3	3
OG0004444	0	0	0	3	3
OG0004445	0	0	0	3	3
OG0004446	0	0	0	3	3
OG0004447	0	0	0	3	3
OG0004448	0	0	0	3	3
OG0004449	0	0	0	3	3
OG0004450	0	0	0	3	3
OG0004451	0	0	0	3	3
OG0004452	0	0	0	3	3
OG0004453	0	0	0	3	3
OG0004454	0	0	0	3	3
OG0004455	0	0	0	3	3
OG0004456	0	0	0	3	3
OG0004457	0	0	0	3	3
OG0004458	0	0	0	3	3
OG0004459	0	0	0	3	3
OG0004460	0	0	0	3	3
OG0004461	0	0	0	3	3
OG0004462	0	0	0	3	3
OG0004463	0	0	0	3	3
OG0004464	0	0	0	3	3
OG0004465	0	0	0	3	3
OG0004466	2	0	0	0	2
OG0004467	2	0	0	0	2
OG0004468	1	0	1	0	2
OG0004469	2	0	0	0	2
OG0004470	2	0	0	0	2
OG0004471	2	0	0	0	2
OG0004472	2	0	0	0	2
OG0004473	1	0	1	0	2
OG0004474	1	0	1	0	2
OG0004475	1	0	1	0	2
OG0004476	2	0	0	0	2
OG0004477	1	1	0	0	2
OG0004478	1	1	0	0	2
OG0004479	1	0	1	0	2
OG0004480	2	0	0	0	2
OG0004481	1	0	0	1	2
OG0004482	1	0	1	0	2
OG0004483	1	1	0	0	2
OG0004484	1	0	1	0	2
OG0004485	2	0	0	0	2
OG0004486	1	0	1	0	2
OG0004487	1	0	1	0	2
OG0004488	2	0	0	0	2
OG0004489	1	0	1	0	2
OG0004490	1	0	1	0	2
OG0004491	1	0	0	1	2
OG0004492	1	1	0	0	2
OG0004493	1	0	1	0	2
OG0004494	2	0	0	0	2
OG0004495	2	0	0	0	2
OG0004496	1	1	0	0	2
OG0004497	1	1	0	0	2
OG0004498	1	1	0	0	2
OG0004499	1	0	1	0	2
OG0004500	2	0	0	0	2
OG0004501	1	0	1	0	2
OG0004502	2	0	0	0	2
OG0004503	1	0	1	0	2
OG0004504	2	0	0	0	2
OG0004505	1	1	0	0	2
OG0004506	1	0	1	0	2
OG0004507	2	0	0	0	2
OG0004508	2	0	0	0	2
OG0004509	2	0	0	0	2
OG0004510	2	0	0	0	2
OG0004511	1	0	1	0	2
OG0004512	1	0	1	0	2
OG0004513	1	0	1	0	2
OG0004514	2	0	0	0	2
OG0004515	1	0	0	1	2
OG0004516	1	0	1	0	2
OG0004517	1	0	1	0	2
OG0004518	2	0	0	0	2
OG0004519	1	0	1	0	2
OG0004520	1	0	1	0	2
OG0004521	2	0	0	0	2
OG0004522	2	0	0	0	2
OG0004523	2	0	0	0	2
OG0004524	2	0	0	0	2
OG0004525	2	0	0	0	2
OG0004526	1	0	1	0	2
OG0004527	1	0	1	0	2
OG0004528	2	0	0	0	2
OG0004529	1	0	1	0	2
OG0004530	1	0	1	0	2
OG0004531	2	0	0	0	2
OG0004532	2	0	0	0	2
OG0004533	1	0	1	0	2
OG0004534	1	0	1	0	2
OG0004535	1	1	0	0	2
OG0004536	1	0	0	1	2
OG0004537	1	0	1	0	2
OG0004538	2	0	0	0	2
OG0004539	1	1	0	0	2
OG0004540	1	1	0	0	2
OG0004541	1	0	1	0	2
OG0004542	2	0	0	0	2
OG0004543	1	1	0	0	2
OG0004544	1	1	0	0	2
OG0004545	2	0	0	0	2
OG0004546	2	0	0	0	2
OG0004547	2	0	0	0	2
OG0004548	2	0	0	0	2
OG0004549	1	0	1	0	2
OG0004550	1	1	0	0	2
OG0004551	2	0	0	0	2
OG0004552	1	0	0	1	2
OG0004553	1	0	1	0	2
OG0004554	1	0	1	0	2
OG0004555	1	0	1	0	2
OG0004556	1	1	0	0	2
OG0004557	2	0	0	0	2
OG0004558	2	0	0	0	2
OG0004559	2	0	0	0	2
OG0004560	2	0	0	0	2
OG0004561	2	0	0	0	2
OG0004562	1	0	0	1	2
OG0004563	2	0	0	0	2
OG0004564	1	0	1	0	2
OG0004565	1	1	0	0	2
OG0004566	1	0	1	0	2
OG0004567	1	0	1	0	2
OG0004568	1	0	1	0	2
OG0004569	1	1	0	0	2
OG0004570	2	0	0	0	2
OG0004571	2	0	0	0	2
OG0004572	1	0	0	1	2
OG0004573	2	0	0	0	2
OG0004574	1	0	1	0	2
OG0004575	1	0	1	0	2
OG0004576	1	0	0	1	2
OG0004577	1	0	1	0	2
OG0004578	1	0	1	0	2
OG0004579	2	0	0	0	2
OG0004580	2	0	0	0	2
OG0004581	1	0	1	0	2
OG0004582	2	0	0	0	2
OG0004583	2	0	0	0	2
OG0004584	1	1	0	0	2
OG0004585	1	0	1	0	2
OG0004586	1	1	0	0	2
OG0004587	2	0	0	0	2
OG0004588	1	1	0	0	2
OG0004589	1	0	1	0	2
OG0004590	2	0	0	0	2
OG0004591	1	0	1	0	2
OG0004592	2	0	0	0	2
OG0004593	2	0	0	0	2
OG0004594	1	0	1	0	2
OG0004595	1	0	1	0	2
OG0004596	1	1	0	0	2
OG0004597	2	0	0	0	2
OG0004598	1	0	0	1	2
OG0004599	2	0	0	0	2
OG0004600	1	0	1	0	2
OG0004601	2	0	0	0	2
OG0004602	1	0	1	0	2
OG0004603	1	0	0	1	2
OG0004604	2	0	0	0	2
OG0004605	1	0	0	1	2
OG0004606	1	0	1	0	2
OG0004607	2	0	0	0	2
OG0004608	1	0	1	0	2
OG0004609	1	0	1	0	2
OG0004610	1	0	1	0	2
OG0004611	1	0	1	0	2
OG0004612	2	0	0	0	2
OG0004613	1	0	1	0	2
OG0004614	1	0	1	0	2
OG0004615	1	1	0	0	2
OG0004616	1	0	1	0	2
OG0004617	1	0	1	0	2
OG0004618	1	0	1	0	2
OG0004619	1	0	1	0	2
OG0004620	1	1	0	0	2
OG0004621	1	0	1	0	2
OG0004622	1	0	1	0	2
OG0004623	1	1	0	0	2
OG0004624	2	0	0	0	2
OG0004625	2	0	0	0	2
OG0004626	1	0	1	0	2
OG0004627	2	0	0	0	2
OG0004628	1	0	1	0	2
OG0004629	1	0	1	0	2
OG0004630	1	1	0	0	2
OG0004631	1	1	0	0	2
OG0004632	1	0	0	1	2
OG0004633	1	0	1	0	2
OG0004634	2	0	0	0	2
OG0004635	1	0	1	0	2
OG0004636	1	1	0	0	2
OG0004637	2	0	0	0	2
OG0004638	1	0	1	0	2
OG0004639	1	0	1	0	2
OG0004640	1	0	1	0	2
OG0004641	1	1	0	0	2
OG0004642	2	0	0	0	2
OG0004643	2	0	0	0	2
OG0004644	1	0	1	0	2
OG0004645	1	0	1	0	2
OG0004646	1	1	0	0	2
OG0004647	2	0	0	0	2
OG0004648	1	0	1	0	2
OG0004649	1	0	1	0	2
OG0004650	1	1	0	0	2
OG0004651	2	0	0	0	2
OG0004652	2	0	0	0	2
OG0004653	2	0	0	0	2
OG0004654	1	0	1	0	2
OG0004655	1	0	1	0	2
OG0004656	1	0	1	0	2
OG0004657	1	0	1	0	2
OG0004658	1	1	0	0	2
OG0004659	1	0	1	0	2
OG0004660	1	0	1	0	2
OG0004661	1	0	1	0	2
OG0004662	2	0	0	0	2
OG0004663	1	1	0	0	2
OG0004664	1	0	1	0	2
OG0004665	1	0	1	0	2
OG0004666	1	0	1	0	2
OG0004667	2	0	0	0	2
OG0004668	2	0	0	0	2
OG0004669	1	0	1	0	2
OG0004670	2	0	0	0	2
OG0004671	1	1	0	0	2
OG0004672	1	0	1	0	2
OG0004673	1	0	1	0	2
OG0004674	1	1	0	0	2
OG0004675	2	0	0	0	2
OG0004676	2	0	0	0	2
OG0004677	1	1	0	0	2
OG0004678	2	0	0	0	2
OG0004679	1	0	1	0	2
OG0004680	2	0	0	0	2
OG0004681	2	0	0	0	2
OG0004682	1	1	0	0	2
OG0004683	1	1	0	0	2
OG0004684	2	0	0	0	2
OG0004685	2	0	0	0	2
OG0004686	2	0	0	0	2
OG0004687	2	0	0	0	2
OG0004688	2	0	0	0	2
OG0004689	1	1	0	0	2
OG0004690	2	0	0	0	2
OG0004691	2	0	0	0	2
OG0004692	2	0	0	0	2
OG0004693	2	0	0	0	2
OG0004694	1	0	1	0	2
OG0004695	1	0	1	0	2
OG0004696	1	0	1	0	2
OG0004697	2	0	0	0	2
OG0004698	1	1	0	0	2
OG0004699	1	0	0	1	2
OG0004700	1	0	1	0	2
OG0004701	1	0	1	0	2
OG0004702	2	0	0	0	2
OG0004703	1	1	0	0	2
OG0004704	1	0	1	0	2
OG0004705	1	1	0	0	2
OG0004706	1	0	1	0	2
OG0004707	1	0	1	0	2
OG0004708	1	1	0	0	2
OG0004709	1	0	1	0	2
OG0004710	1	1	0	0	2
OG0004711	1	0	0	1	2
OG0004712	1	0	1	0	2
OG0004713	1	0	1	0	2
OG0004714	1	1	0	0	2
OG0004715	1	0	1	0	2
OG0004716	2	0	0	0	2
OG0004717	1	0	1	0	2
OG0004718	2	0	0	0	2
OG0004719	1	1	0	0	2
OG0004720	1	0	1	0	2
OG0004721	1	1	0	0	2
OG0004722	1	1	0	0	2
OG0004723	1	0	1	0	2
OG0004724	1	0	0	1	2
OG0004725	1	1	0	0	2
OG0004726	1	0	1	0	2
OG0004727	2	0	0	0	2
OG0004728	2	0	0	0	2
OG0004729	1	0	1	0	2
OG0004730	1	0	1	0	2
OG0004731	2	0	0	0	2
OG0004732	2	0	0	0	2
OG0004733	1	0	1	0	2
OG0004734	2	0	0	0	2
OG0004735	2	0	0	0	2
OG0004736	1	1	0	0	2
OG0004737	1	0	1	0	2
OG0004738	1	0	0	1	2
OG0004739	2	0	0	0	2
OG0004740	2	0	0	0	2
OG0004741	1	1	0	0	2
OG0004742	2	0	0	0	2
OG0004743	2	0	0	0	2
OG0004744	1	0	1	0	2
OG0004745	2	0	0	0	2
OG0004746	2	0	0	0	2
OG0004747	2	0	0	0	2
OG0004748	1	1	0	0	2
OG0004749	2	0	0	0	2
OG0004750	2	0	0	0	2
OG0004751	1	0	1	0	2
OG0004752	2	0	0	0	2
OG0004753	2	0	0	0	2
OG0004754	1	1	0	0	2
OG0004755	1	0	1	0	2
OG0004756	1	0	1	0	2
OG0004757	1	0	1	0	2
OG0004758	1	0	1	0	2
OG0004759	2	0	0	0	2
OG0004760	1	0	1	0	2
OG0004761	2	0	0	0	2
OG0004762	1	0	1	0	2
OG0004763	1	0	1	0	2
OG0004764	1	0	1	0	2
OG0004765	2	0	0	0	2
OG0004766	2	0	0	0	2
OG0004767	2	0	0	0	2
OG0004768	2	0	0	0	2
OG0004769	2	0	0	0	2
OG0004770	2	0	0	0	2
OG0004771	2	0	0	0	2
OG0004772	2	0	0	0	2
OG0004773	1	0	1	0	2
OG0004774	1	0	1	0	2
OG0004775	1	0	1	0	2
OG0004776	2	0	0	0	2
OG0004777	1	0	1	0	2
OG0004778	2	0	0	0	2
OG0004779	2	0	0	0	2
OG0004780	1	1	0	0	2
OG0004781	1	0	1	0	2
OG0004782	1	0	0	1	2
OG0004783	1	0	1	0	2
OG0004784	1	0	1	0	2
OG0004785	1	0	1	0	2
OG0004786	1	0	1	0	2
OG0004787	1	1	0	0	2
OG0004788	1	0	1	0	2
OG0004789	2	0	0	0	2
OG0004790	1	0	1	0	2
OG0004791	1	1	0	0	2
OG0004792	1	0	1	0	2
OG0004793	2	0	0	0	2
OG0004794	1	0	1	0	2
OG0004795	2	0	0	0	2
OG0004796	2	0	0	0	2
OG0004797	1	0	1	0	2
OG0004798	1	0	1	0	2
OG0004799	1	0	1	0	2
OG0004800	1	0	1	0	2
OG0004801	2	0	0	0	2
OG0004802	2	0	0	0	2
OG0004803	2	0	0	0	2
OG0004804	1	1	0	0	2
OG0004805	1	0	1	0	2
OG0004806	2	0	0	0	2
OG0004807	2	0	0	0	2
OG0004808	2	0	0	0	2
OG0004809	2	0	0	0	2
OG0004810	2	0	0	0	2
OG0004811	1	0	1	0	2
OG0004812	1	1	0	0	2
OG0004813	2	0	0	0	2
OG0004814	2	0	0	0	2
OG0004815	2	0	0	0	2
OG0004816	1	0	1	0	2
OG0004817	2	0	0	0	2
OG0004818	1	1	0	0	2
OG0004819	2	0	0	0	2
OG0004820	1	0	1	0	2
OG0004821	2	0	0	0	2
OG0004822	1	0	1	0	2
OG0004823	1	0	1	0	2
OG0004824	1	0	1	0	2
OG0004825	2	0	0	0	2
OG0004826	1	0	1	0	2
OG0004827	1	0	1	0	2
OG0004828	1	0	1	0	2
OG0004829	1	0	1	0	2
OG0004830	2	0	0	0	2
OG0004831	1	0	1	0	2
OG0004832	1	1	0	0	2
OG0004833	2	0	0	0	2
OG0004834	2	0	0	0	2
OG0004835	2	0	0	0	2
OG0004836	1	0	1	0	2
OG0004837	1	1	0	0	2
OG0004838	1	0	1	0	2
OG0004839	2	0	0	0	2
OG0004840	1	0	1	0	2
OG0004841	1	0	1	0	2
OG0004842	2	0	0	0	2
OG0004843	1	1	0	0	2
OG0004844	2	0	0	0	2
OG0004845	1	0	1	0	2
OG0004846	2	0	0	0	2
OG0004847	2	0	0	0	2
OG0004848	1	1	0	0	2
OG0004849	1	1	0	0	2
OG0004850	1	0	1	0	2
OG0004851	1	0	1	0	2
OG0004852	1	0	0	1	2
OG0004853	1	0	1	0	2
OG0004854	2	0	0	0	2
OG0004855	2	0	0	0	2
OG0004856	1	0	1	0	2
OG0004857	1	1	0	0	2
OG0004858	1	0	1	0	2
OG0004859	1	1	0	0	2
OG0004860	2	0	0	0	2
OG0004861	2	0	0	0	2
OG0004862	1	0	1	0	2
OG0004863	1	0	1	0	2
OG0004864	2	0	0	0	2
OG0004865	1	0	1	0	2
OG0004866	1	0	1	0	2
OG0004867	2	0	0	0	2
OG0004868	1	0	1	0	2
OG0004869	1	0	1	0	2
OG0004870	1	0	1	0	2
OG0004871	1	0	1	0	2
OG0004872	1	1	0	0	2
OG0004873	2	0	0	0	2
OG0004874	1	0	1	0	2
OG0004875	2	0	0	0	2
OG0004876	2	0	0	0	2
OG0004877	1	0	1	0	2
OG0004878	1	1	0	0	2
OG0004879	1	0	1	0	2
OG0004880	2	0	0	0	2
OG0004881	1	0	1	0	2
OG0004882	1	0	1	0	2
OG0004883	1	0	1	0	2
OG0004884	2	0	0	0	2
OG0004885	2	0	0	0	2
OG0004886	2	0	0	0	2
OG0004887	2	0	0	0	2
OG0004888	2	0	0	0	2
OG0004889	2	0	0	0	2
OG0004890	1	0	1	0	2
OG0004891	2	0	0	0	2
OG0004892	1	1	0	0	2
OG0004893	2	0	0	0	2
OG0004894	2	0	0	0	2
OG0004895	1	1	0	0	2
OG0004896	2	0	0	0	2
OG0004897	1	0	1	0	2
OG0004898	2	0	0	0	2
OG0004899	1	0	1	0	2
OG0004900	1	1	0	0	2
OG0004901	1	0	1	0	2
OG0004902	1	0	1	0	2
OG0004903	1	1	0	0	2
OG0004904	1	0	1	0	2
OG0004905	1	0	1	0	2
OG0004906	2	0	0	0	2
OG0004907	1	1	0	0	2
OG0004908	1	0	1	0	2
OG0004909	2	0	0	0	2
OG0004910	1	0	1	0	2
OG0004911	1	0	1	0	2
OG0004912	2	0	0	0	2
OG0004913	1	0	1	0	2
OG0004914	1	0	1	0	2
OG0004915	2	0	0	0	2
OG0004916	1	1	0	0	2
OG0004917	1	0	1	0	2
OG0004918	2	0	0	0	2
OG0004919	1	1	0	0	2
OG0004920	2	0	0	0	2
OG0004921	1	0	1	0	2
OG0004922	2	0	0	0	2
OG0004923	2	0	0	0	2
OG0004924	2	0	0	0	2
OG0004925	2	0	0	0	2
OG0004926	2	0	0	0	2
OG0004927	2	0	0	0	2
OG0004928	2	0	0	0	2
OG0004929	1	0	1	0	2
OG0004930	1	0	1	0	2
OG0004931	1	0	1	0	2
OG0004932	1	0	1	0	2
OG0004933	1	0	1	0	2
OG0004934	1	0	1	0	2
OG0004935	2	0	0	0	2
OG0004936	2	0	0	0	2
OG0004937	1	0	1	0	2
OG0004938	1	1	0	0	2
OG0004939	2	0	0	0	2
OG0004940	1	1	0	0	2
OG0004941	1	0	1	0	2
OG0004942	2	0	0	0	2
OG0004943	1	1	0	0	2
OG0004944	1	0	1	0	2
OG0004945	1	0	1	0	2
OG0004946	2	0	0	0	2
OG0004947	2	0	0	0	2
OG0004948	2	0	0	0	2
OG0004949	1	0	1	0	2
OG0004950	1	0	1	0	2
OG0004951	1	0	1	0	2
OG0004952	2	0	0	0	2
OG0004953	1	1	0	0	2
OG0004954	1	0	1	0	2
OG0004955	2	0	0	0	2
OG0004956	1	0	1	0	2
OG0004957	1	0	1	0	2
OG0004958	1	0	1	0	2
OG0004959	1	0	1	0	2
OG0004960	1	0	0	1	2
OG0004961	2	0	0	0	2
OG0004962	1	0	1	0	2
OG0004963	1	0	1	0	2
OG0004964	1	0	0	1	2
OG0004965	1	1	0	0	2
OG0004966	1	0	1	0	2
OG0004967	2	0	0	0	2
OG0004968	2	0	0	0	2
OG0004969	1	1	0	0	2
OG0004970	2	0	0	0	2
OG0004971	1	1	0	0	2
OG0004972	1	0	1	0	2
OG0004973	2	0	0	0	2
OG0004974	1	1	0	0	2
OG0004975	1	0	1	0	2
OG0004976	1	1	0	0	2
OG0004977	1	0	0	1	2
OG0004978	1	0	1	0	2
OG0004979	1	0	1	0	2
OG0004980	2	0	0	0	2
OG0004981	1	0	1	0	2
OG0004982	2	0	0	0	2
OG0004983	1	0	1	0	2
OG0004984	1	0	1	0	2
OG0004985	2	0	0	0	2
OG0004986	2	0	0	0	2
OG0004987	2	0	0	0	2
OG0004988	1	1	0	0	2
OG0004989	1	0	1	0	2
OG0004990	1	0	1	0	2
OG0004991	1	0	1	0	2
OG0004992	1	0	1	0	2
OG0004993	1	0	1	0	2
OG0004994	1	1	0	0	2
OG0004995	2	0	0	0	2
OG0004996	1	0	1	0	2
OG0004997	1	1	0	0	2
OG0004998	1	0	1	0	2
OG0004999	1	0	1	0	2
OG0005000	2	0	0	0	2
OG0005001	1	0	1	0	2
OG0005002	1	1	0	0	2
OG0005003	1	0	1	0	2
OG0005004	2	0	0	0	2
OG0005005	1	0	1	0	2
OG0005006	1	0	1	0	2
OG0005007	1	0	1	0	2
OG0005008	1	0	1	0	2
OG0005009	1	1	0	0	2
OG0005010	1	0	1	0	2
OG0005011	1	0	1	0	2
OG0005012	1	0	1	0	2
OG0005013	2	0	0	0	2
OG0005014	2	0	0	0	2
OG0005015	1	0	1	0	2
OG0005016	1	0	1	0	2
OG0005017	1	0	1	0	2
OG0005018	1	0	1	0	2
OG0005019	1	1	0	0	2
OG0005020	1	0	1	0	2
OG0005021	2	0	0	0	2
OG0005022	2	0	0	0	2
OG0005023	2	0	0	0	2
OG0005024	2	0	0	0	2
OG0005025	2	0	0	0	2
OG0005026	2	0	0	0	2
OG0005027	2	0	0	0	2
OG0005028	2	0	0	0	2
OG0005029	2	0	0	0	2
OG0005030	2	0	0	0	2
OG0005031	2	0	0	0	2
OG0005032	2	0	0	0	2
OG0005033	2	0	0	0	2
OG0005034	1	0	1	0	2
OG0005035	1	0	1	0	2
OG0005036	1	0	1	0	2
OG0005037	1	0	1	0	2
OG0005038	1	0	1	0	2
OG0005039	1	0	1	0	2
OG0005040	1	0	1	0	2
OG0005041	1	1	0	0	2
OG0005042	1	0	0	1	2
OG0005043	1	1	0	0	2
OG0005044	1	0	1	0	2
OG0005045	1	0	1	0	2
OG0005046	1	1	0	0	2
OG0005047	1	0	1	0	2
OG0005048	1	1	0	0	2
OG0005049	1	0	1	0	2
OG0005050	1	1	0	0	2
OG0005051	1	0	1	0	2
OG0005052	1	1	0	0	2
OG0005053	1	0	1	0	2
OG0005054	1	0	1	0	2
OG0005055	2	0	0	0	2
OG0005056	2	0	0	0	2
OG0005057	2	0	0	0	2
OG0005058	2	0	0	0	2
OG0005059	2	0	0	0	2
OG0005060	2	0	0	0	2
OG0005061	2	0	0	0	2
OG0005062	1	0	1	0	2
OG0005063	2	0	0	0	2
OG0005064	1	0	1	0	2
OG0005065	2	0	0	0	2
OG0005066	2	0	0	0	2
OG0005067	2	0	0	0	2
OG0005068	2	0	0	0	2
OG0005069	1	0	1	0	2
OG0005070	1	0	1	0	2
OG0005071	1	1	0	0	2
OG0005072	1	1	0	0	2
OG0005073	1	1	0	0	2
OG0005074	1	0	1	0	2
OG0005075	1	1	0	0	2
OG0005076	1	0	1	0	2
OG0005077	1	0	1	0	2
OG0005078	1	1	0	0	2
OG0005079	1	0	1	0	2
OG0005080	1	0	1	0	2
OG0005081	1	0	1	0	2
OG0005082	1	0	1	0	2
OG0005083	1	1	0	0	2
OG0005084	1	0	1	0	2
OG0005085	1	0	1	0	2
OG0005086	1	0	1	0	2
OG0005087	1	0	1	0	2
OG0005088	1	1	0	0	2
OG0005089	0	2	0	0	2
OG0005090	0	1	1	0	2
OG0005091	0	2	0	0	2
OG0005092	0	2	0	0	2
OG0005093	0	1	1	0	2
OG0005094	0	2	0	0	2
OG0005095	0	2	0	0	2
OG0005096	0	1	1	0	2
OG0005097	0	1	1	0	2
OG0005098	0	1	1	0	2
OG0005099	0	2	0	0	2
OG0005100	0	2	0	0	2
OG0005101	0	2	0	0	2
OG0005102	0	2	0	0	2
OG0005103	0	2	0	0	2
OG0005104	0	2	0	0	2
OG0005105	0	2	0	0	2
OG0005106	0	2	0	0	2
OG0005107	0	1	1	0	2
OG0005108	0	1	1	0	2
OG0005109	0	2	0	0	2
OG0005110	0	1	1	0	2
OG0005111	0	2	0	0	2
OG0005112	0	1	1	0	2
OG0005113	0	1	1	0	2
OG0005114	0	1	1	0	2
OG0005115	0	2	0	0	2
OG0005116	0	2	0	0	2
OG0005117	0	2	0	0	2
OG0005118	0	1	1	0	2
OG0005119	0	2	0	0	2
OG0005120	0	1	1	0	2
OG0005121	0	1	1	0	2
OG0005122	0	1	1	0	2
OG0005123	0	1	1	0	2
OG0005124	0	1	1	0	2
OG0005125	0	2	0	0	2
OG0005126	0	2	0	0	2
OG0005127	0	2	0	0	2
OG0005128	0	2	0	0	2
OG0005129	0	2	0	0	2
OG0005130	0	2	0	0	2
OG0005131	0	2	0	0	2
OG0005132	0	2	0	0	2
OG0005133	0	2	0	0	2
OG0005134	0	2	0	0	2
OG0005135	0	2	0	0	2
OG0005136	0	1	1	0	2
OG0005137	0	2	0	0	2
OG0005138	0	1	1	0	2
OG0005139	0	2	0	0	2
OG0005140	0	2	0	0	2
OG0005141	0	2	0	0	2
OG0005142	0	2	0	0	2
OG0005143	0	2	0	0	2
OG0005144	0	1	1	0	2
OG0005145	0	2	0	0	2
OG0005146	0	2	0	0	2
OG0005147	0	2	0	0	2
OG0005148	0	2	0	0	2
OG0005149	0	2	0	0	2
OG0005150	0	2	0	0	2
OG0005151	0	2	0	0	2
OG0005152	0	2	0	0	2
OG0005153	0	2	0	0	2
OG0005154	0	1	1	0	2
OG0005155	0	2	0	0	2
OG0005156	0	1	1	0	2
OG0005157	0	1	1	0	2
OG0005158	0	2	0	0	2
OG0005159	0	1	1	0	2
OG0005160	0	2	0	0	2
OG0005161	0	1	1	0	2
OG0005162	0	2	0	0	2
OG0005163	0	1	1	0	2
OG0005164	0	1	1	0	2
OG0005165	0	2	0	0	2
OG0005166	0	2	0	0	2
OG0005167	0	2	0	0	2
OG0005168	0	2	0	0	2
OG0005169	0	2	0	0	2
OG0005170	0	2	0	0	2
OG0005171	0	1	1	0	2
OG0005172	0	1	1	0	2
OG0005173	0	2	0	0	2
OG0005174	0	2	0	0	2
OG0005175	0	1	1	0	2
OG0005176	0	1	1	0	2
OG0005177	0	1	1	0	2
OG0005178	0	1	1	0	2
OG0005179	0	2	0	0	2
OG0005180	0	1	1	0	2
OG0005181	0	1	1	0	2
OG0005182	0	2	0	0	2
OG0005183	0	2	0	0	2
OG0005184	0	1	1	0	2
OG0005185	0	1	1	0	2
OG0005186	0	1	1	0	2
OG0005187	0	1	1	0	2
OG0005188	0	2	0	0	2
OG0005189	0	1	1	0	2
OG0005190	0	1	1	0	2
OG0005191	0	1	1	0	2
OG0005192	0	1	1	0	2
OG0005193	0	1	1	0	2
OG0005194	0	2	0	0	2
OG0005195	0	1	1	0	2
OG0005196	0	2	0	0	2
OG0005197	0	1	1	0	2
OG0005198	0	2	0	0	2
OG0005199	0	2	0	0	2
OG0005200	0	1	1	0	2
OG0005201	0	1	1	0	2
OG0005202	0	1	1	0	2
OG0005203	0	1	1	0	2
OG0005204	0	2	0	0	2
OG0005205	0	1	1	0	2
OG0005206	0	2	0	0	2
OG0005207	0	1	1	0	2
OG0005208	0	2	0	0	2
OG0005209	0	2	0	0	2
OG0005210	0	2	0	0	2
OG0005211	0	2	0	0	2
OG0005212	0	2	0	0	2
OG0005213	0	1	1	0	2
OG0005214	0	1	1	0	2
OG0005215	0	1	1	0	2
OG0005216	0	1	1	0	2
OG0005217	0	2	0	0	2
OG0005218	0	1	1	0	2
OG0005219	0	1	1	0	2
OG0005220	0	2	0	0	2
OG0005221	0	2	0	0	2
OG0005222	0	2	0	0	2
OG0005223	0	2	0	0	2
OG0005224	0	1	1	0	2
OG0005225	0	1	0	1	2
OG0005226	0	1	1	0	2
OG0005227	0	2	0	0	2
OG0005228	0	1	1	0	2
OG0005229	0	1	1	0	2
OG0005230	0	2	0	0	2
OG0005231	0	1	1	0	2
OG0005232	0	1	0	1	2
OG0005233	0	1	1	0	2
OG0005234	0	1	1	0	2
OG0005235	0	1	1	0	2
OG0005236	0	2	0	0	2
OG0005237	0	1	1	0	2
OG0005238	0	2	0	0	2
OG0005239	0	1	1	0	2
OG0005240	0	1	1	0	2
OG0005241	0	1	0	1	2
OG0005242	0	2	0	0	2
OG0005243	0	2	0	0	2
OG0005244	0	2	0	0	2
OG0005245	0	1	0	1	2
OG0005246	0	2	0	0	2
OG0005247	0	2	0	0	2
OG0005248	0	2	0	0	2
OG0005249	0	2	0	0	2
OG0005250	0	2	0	0	2
OG0005251	0	2	0	0	2
OG0005252	0	2	0	0	2
OG0005253	0	2	0	0	2
OG0005254	0	1	1	0	2
OG0005255	0	2	0	0	2
OG0005256	0	2	0	0	2
OG0005257	0	2	0	0	2
OG0005258	0	1	1	0	2
OG0005259	0	1	1	0	2
OG0005260	0	2	0	0	2
OG0005261	0	1	1	0	2
OG0005262	0	1	1	0	2
OG0005263	0	2	0	0	2
OG0005264	0	1	1	0	2
OG0005265	0	2	0	0	2
OG0005266	0	1	1	0	2
OG0005267	0	1	1	0	2
OG0005268	0	1	1	0	2
OG0005269	0	1	1	0	2
OG0005270	0	1	1	0	2
OG0005271	0	2	0	0	2
OG0005272	0	2	0	0	2
OG0005273	0	2	0	0	2
OG0005274	0	2	0	0	2
OG0005275	0	1	1	0	2
OG0005276	0	1	1	0	2
OG0005277	0	1	1	0	2
OG0005278	0	2	0	0	2
OG0005279	0	1	1	0	2
OG0005280	0	2	0	0	2
OG0005281	0	2	0	0	2
OG0005282	0	1	1	0	2
OG0005283	0	1	1	0	2
OG0005284	0	1	1	0	2
OG0005285	0	1	1	0	2
OG0005286	0	1	1	0	2
OG0005287	0	2	0	0	2
OG0005288	0	2	0	0	2
OG0005289	0	2	0	0	2
OG0005290	0	2	0	0	2
OG0005291	0	1	1	0	2
OG0005292	0	2	0	0	2
OG0005293	0	1	1	0	2
OG0005294	0	1	1	0	2
OG0005295	0	1	0	1	2
OG0005296	0	2	0	0	2
OG0005297	0	2	0	0	2
OG0005298	0	1	1	0	2
OG0005299	0	1	1	0	2
OG0005300	0	2	0	0	2
OG0005301	0	1	0	1	2
OG0005302	0	2	0	0	2
OG0005303	0	2	0	0	2
OG0005304	0	1	1	0	2
OG0005305	0	1	1	0	2
OG0005306	0	2	0	0	2
OG0005307	0	1	1	0	2
OG0005308	0	1	1	0	2
OG0005309	0	1	1	0	2
OG0005310	0	1	1	0	2
OG0005311	0	2	0	0	2
OG0005312	0	1	1	0	2
OG0005313	0	2	0	0	2
OG0005314	0	2	0	0	2
OG0005315	0	2	0	0	2
OG0005316	0	2	0	0	2
OG0005317	0	2	0	0	2
OG0005318	0	2	0	0	2
OG0005319	0	1	1	0	2
OG0005320	0	1	1	0	2
OG0005321	0	1	1	0	2
OG0005322	0	2	0	0	2
OG0005323	0	1	1	0	2
OG0005324	0	2	0	0	2
OG0005325	0	2	0	0	2
OG0005326	0	2	0	0	2
OG0005327	0	2	0	0	2
OG0005328	0	1	1	0	2
OG0005329	0	2	0	0	2
OG0005330	0	2	0	0	2
OG0005331	0	1	1	0	2
OG0005332	0	1	1	0	2
OG0005333	0	2	0	0	2
OG0005334	0	1	1	0	2
OG0005335	0	2	0	0	2
OG0005336	0	2	0	0	2
OG0005337	0	1	1	0	2
OG0005338	0	1	1	0	2
OG0005339	0	1	1	0	2
OG0005340	0	1	1	0	2
OG0005341	0	2	0	0	2
OG0005342	0	2	0	0	2
OG0005343	0	1	1	0	2
OG0005344	0	1	1	0	2
OG0005345	0	1	1	0	2
OG0005346	0	2	0	0	2
OG0005347	0	1	1	0	2
OG0005348	0	1	1	0	2
OG0005349	0	2	0	0	2
OG0005350	0	2	0	0	2
OG0005351	0	2	0	0	2
OG0005352	0	2	0	0	2
OG0005353	0	2	0	0	2
OG0005354	0	2	0	0	2
OG0005355	0	2	0	0	2
OG0005356	0	2	0	0	2
OG0005357	0	2	0	0	2
OG0005358	0	2	0	0	2
OG0005359	0	1	1	0	2
OG0005360	0	2	0	0	2
OG0005361	0	2	0	0	2
OG0005362	0	2	0	0	2
OG0005363	0	1	1	0	2
OG0005364	0	1	1	0	2
OG0005365	0	1	1	0	2
OG0005366	0	2	0	0	2
OG0005367	0	1	0	1	2
OG0005368	0	2	0	0	2
OG0005369	0	1	1	0	2
OG0005370	0	1	1	0	2
OG0005371	0	1	1	0	2
OG0005372	0	1	1	0	2
OG0005373	0	2	0	0	2
OG0005374	0	2	0	0	2
OG0005375	0	1	1	0	2
OG0005376	0	2	0	0	2
OG0005377	0	2	0	0	2
OG0005378	0	1	1	0	2
OG0005379	0	2	0	0	2
OG0005380	0	1	1	0	2
OG0005381	0	2	0	0	2
OG0005382	0	1	1	0	2
OG0005383	0	1	1	0	2
OG0005384	0	1	1	0	2
OG0005385	0	1	1	0	2
OG0005386	0	1	1	0	2
OG0005387	0	1	1	0	2
OG0005388	0	1	1	0	2
OG0005389	0	2	0	0	2
OG0005390	0	1	1	0	2
OG0005391	0	1	1	0	2
OG0005392	0	1	1	0	2
OG0005393	0	2	0	0	2
OG0005394	0	2	0	0	2
OG0005395	0	1	1	0	2
OG0005396	0	1	1	0	2
OG0005397	0	2	0	0	2
OG0005398	0	2	0	0	2
OG0005399	0	1	1	0	2
OG0005400	0	1	1	0	2
OG0005401	0	1	1	0	2
OG0005402	0	1	1	0	2
OG0005403	0	1	1	0	2
OG0005404	0	1	1	0	2
OG0005405	0	1	1	0	2
OG0005406	0	1	1	0	2
OG0005407	0	1	1	0	2
OG0005408	0	1	1	0	2
OG0005409	0	1	1	0	2
OG0005410	0	1	1	0	2
OG0005411	0	1	1	0	2
OG0005412	0	1	1	0	2
OG0005413	0	1	0	1	2
OG0005414	0	2	0	0	2
OG0005415	0	1	1	0	2
OG0005416	0	2	0	0	2
OG0005417	0	1	1	0	2
OG0005418	0	1	0	1	2
OG0005419	0	1	1	0	2
OG0005420	0	1	1	0	2
OG0005421	0	1	1	0	2
OG0005422	0	2	0	0	2
OG0005423	0	1	1	0	2
OG0005424	0	2	0	0	2
OG0005425	0	1	1	0	2
OG0005426	0	2	0	0	2
OG0005427	0	2	0	0	2
OG0005428	0	1	1	0	2
OG0005429	0	1	1	0	2
OG0005430	0	2	0	0	2
OG0005431	0	2	0	0	2
OG0005432	0	1	1	0	2
OG0005433	0	1	1	0	2
OG0005434	0	1	1	0	2
OG0005435	0	2	0	0	2
OG0005436	0	2	0	0	2
OG0005437	0	2	0	0	2
OG0005438	0	1	1	0	2
OG0005439	0	1	1	0	2
OG0005440	0	1	1	0	2
OG0005441	0	1	1	0	2
OG0005442	0	2	0	0	2
OG0005443	0	1	1	0	2
OG0005444	0	2	0	0	2
OG0005445	0	1	1	0	2
OG0005446	0	1	1	0	2
OG0005447	0	1	1	0	2
OG0005448	0	1	1	0	2
OG0005449	0	1	1	0	2
OG0005450	0	1	1	0	2
OG0005451	0	1	1	0	2
OG0005452	0	1	1	0	2
OG0005453	0	1	1	0	2
OG0005454	0	1	1	0	2
OG0005455	0	2	0	0	2
OG0005456	0	2	0	0	2
OG0005457	0	1	1	0	2
OG0005458	0	1	1	0	2
OG0005459	0	2	0	0	2
OG0005460	0	1	1	0	2
OG0005461	0	1	1	0	2
OG0005462	0	1	1	0	2
OG0005463	0	1	1	0	2
OG0005464	0	2	0	0	2
OG0005465	0	1	1	0	2
OG0005466	0	1	1	0	2
OG0005467	0	2	0	0	2
OG0005468	0	2	0	0	2
OG0005469	0	1	1	0	2
OG0005470	0	1	1	0	2
OG0005471	0	1	1	0	2
OG0005472	0	1	0	1	2
OG0005473	0	2	0	0	2
OG0005474	0	2	0	0	2
OG0005475	0	1	1	0	2
OG0005476	0	1	1	0	2
OG0005477	0	1	1	0	2
OG0005478	0	1	1	0	2
OG0005479	0	1	1	0	2
OG0005480	0	1	1	0	2
OG0005481	0	1	1	0	2
OG0005482	0	1	1	0	2
OG0005483	0	1	1	0	2
OG0005484	0	1	1	0	2
OG0005485	0	1	1	0	2
OG0005486	0	1	1	0	2
OG0005487	0	2	0	0	2
OG0005488	0	1	1	0	2
OG0005489	0	2	0	0	2
OG0005490	0	1	1	0	2
OG0005491	0	1	1	0	2
OG0005492	0	1	1	0	2
OG0005493	0	1	1	0	2
OG0005494	0	1	1	0	2
OG0005495	0	1	0	1	2
OG0005496	0	1	1	0	2
OG0005497	0	1	1	0	2
OG0005498	0	1	1	0	2
OG0005499	0	2	0	0	2
OG0005500	0	2	0	0	2
OG0005501	0	2	0	0	2
OG0005502	0	1	1	0	2
OG0005503	0	2	0	0	2
OG0005504	0	2	0	0	2
OG0005505	0	1	1	0	2
OG0005506	0	1	1	0	2
OG0005507	0	1	1	0	2
OG0005508	0	1	1	0	2
OG0005509	0	1	1	0	2
OG0005510	0	1	1	0	2
OG0005511	0	2	0	0	2
OG0005512	0	2	0	0	2
OG0005513	0	2	0	0	2
OG0005514	0	2	0	0	2
OG0005515	0	2	0	0	2
OG0005516	0	1	1	0	2
OG0005517	0	1	1	0	2
OG0005518	0	1	1	0	2
OG0005519	0	1	1	0	2
OG0005520	0	1	1	0	2
OG0005521	0	2	0	0	2
OG0005522	0	1	1	0	2
OG0005523	0	1	1	0	2
OG0005524	0	2	0	0	2
OG0005525	0	2	0	0	2
OG0005526	0	1	1	0	2
OG0005527	0	2	0	0	2
OG0005528	0	2	0	0	2
OG0005529	0	1	1	0	2
OG0005530	0	2	0	0	2
OG0005531	0	1	1	0	2
OG0005532	0	1	1	0	2
OG0005533	0	2	0	0	2
OG0005534	0	1	1	0	2
OG0005535	0	1	1	0	2
OG0005536	0	2	0	0	2
OG0005537	0	1	1	0	2
OG0005538	0	1	1	0	2
OG0005539	0	1	1	0	2
OG0005540	0	1	1	0	2
OG0005541	0	1	1	0	2
OG0005542	0	1	1	0	2
OG0005543	0	2	0	0	2
OG0005544	0	1	1	0	2
OG0005545	0	1	1	0	2
OG0005546	0	1	1	0	2
OG0005547	0	1	1	0	2
OG0005548	0	2	0	0	2
OG0005549	0	1	1	0	2
OG0005550	0	1	1	0	2
OG0005551	0	1	1	0	2
OG0005552	0	2	0	0	2
OG0005553	0	1	1	0	2
OG0005554	0	2	0	0	2
OG0005555	0	2	0	0	2
OG0005556	0	2	0	0	2
OG0005557	0	1	1	0	2
OG0005558	0	2	0	0	2
OG0005559	0	2	0	0	2
OG0005560	0	2	0	0	2
OG0005561	0	1	1	0	2
OG0005562	0	1	1	0	2
OG0005563	0	2	0	0	2
OG0005564	0	2	0	0	2
OG0005565	0	1	1	0	2
OG0005566	0	2	0	0	2
OG0005567	0	2	0	0	2
OG0005568	0	2	0	0	2
OG0005569	0	2	0	0	2
OG0005570	0	1	1	0	2
OG0005571	0	1	1	0	2
OG0005572	0	1	1	0	2
OG0005573	0	1	1	0	2
OG0005574	0	1	1	0	2
OG0005575	0	1	1	0	2
OG0005576	0	2	0	0	2
OG0005577	0	2	0	0	2
OG0005578	0	1	1	0	2
OG0005579	0	2	0	0	2
OG0005580	0	2	0	0	2
OG0005581	0	1	1	0	2
OG0005582	0	1	1	0	2
OG0005583	0	1	1	0	2
OG0005584	0	1	1	0	2
OG0005585	0	1	1	0	2
OG0005586	0	2	0	0	2
OG0005587	0	2	0	0	2
OG0005588	0	2	0	0	2
OG0005589	0	1	1	0	2
OG0005590	0	1	1	0	2
OG0005591	0	1	1	0	2
OG0005592	0	1	1	0	2
OG0005593	0	2	0	0	2
OG0005594	0	1	1	0	2
OG0005595	0	1	1	0	2
OG0005596	0	2	0	0	2
OG0005597	0	1	1	0	2
OG0005598	0	1	1	0	2
OG0005599	0	1	1	0	2
OG0005600	0	1	1	0	2
OG0005601	0	2	0	0	2
OG0005602	0	1	1	0	2
OG0005603	0	1	1	0	2
OG0005604	0	1	1	0	2
OG0005605	0	1	1	0	2
OG0005606	0	1	1	0	2
OG0005607	0	2	0	0	2
OG0005608	0	2	0	0	2
OG0005609	0	1	1	0	2
OG0005610	0	1	1	0	2
OG0005611	0	2	0	0	2
OG0005612	0	2	0	0	2
OG0005613	0	2	0	0	2
OG0005614	0	1	1	0	2
OG0005615	0	2	0	0	2
OG0005616	0	1	1	0	2
OG0005617	0	1	1	0	2
OG0005618	0	1	1	0	2
OG0005619	0	1	1	0	2
OG0005620	0	1	1	0	2
OG0005621	0	2	0	0	2
OG0005622	0	1	1	0	2
OG0005623	0	1	1	0	2
OG0005624	0	1	1	0	2
OG0005625	0	1	1	0	2
OG0005626	0	1	1	0	2
OG0005627	0	1	1	0	2
OG0005628	0	2	0	0	2
OG0005629	0	1	1	0	2
OG0005630	0	1	1	0	2
OG0005631	0	1	1	0	2
OG0005632	0	1	1	0	2
OG0005633	0	2	0	0	2
OG0005634	0	1	1	0	2
OG0005635	0	1	1	0	2
OG0005636	0	1	1	0	2
OG0005637	0	1	1	0	2
OG0005638	0	1	1	0	2
OG0005639	0	1	1	0	2
OG0005640	0	1	1	0	2
OG0005641	0	1	1	0	2
OG0005642	0	1	1	0	2
OG0005643	0	1	1	0	2
OG0005644	0	1	1	0	2
OG0005645	0	1	1	0	2
OG0005646	0	1	1	0	2
OG0005647	0	1	1	0	2
OG0005648	0	1	1	0	2
OG0005649	0	2	0	0	2
OG0005650	0	2	0	0	2
OG0005651	0	2	0	0	2
OG0005652	0	1	0	1	2
OG0005653	0	1	0	1	2
OG0005654	0	1	1	0	2
OG0005655	0	1	1	0	2
OG0005656	0	1	1	0	2
OG0005657	0	1	1	0	2
OG0005658	0	1	1	0	2
OG0005659	0	1	1	0	2
OG0005660	0	1	1	0	2
OG0005661	0	1	1	0	2
OG0005662	0	1	1	0	2
OG0005663	0	1	1	0	2
OG0005664	0	1	1	0	2
OG0005665	0	1	1	0	2
OG0005666	0	1	1	0	2
OG0005667	0	1	0	1	2
OG0005668	0	1	1	0	2
OG0005669	0	2	0	0	2
OG0005670	0	1	1	0	2
OG0005671	0	1	1	0	2
OG0005672	0	1	1	0	2
OG0005673	0	1	1	0	2
OG0005674	0	1	1	0	2
OG0005675	0	1	1	0	2
OG0005676	0	2	0	0	2
OG0005677	0	1	1	0	2
OG0005678	0	1	1	0	2
OG0005679	0	1	1	0	2
OG0005680	0	1	1	0	2
OG0005681	0	1	1	0	2
OG0005682	0	1	1	0	2
OG0005683	0	1	1	0	2
OG0005684	0	1	1	0	2
OG0005685	0	1	1	0	2
OG0005686	0	2	0	0	2
OG0005687	0	1	1	0	2
OG0005688	0	1	1	0	2
OG0005689	0	1	1	0	2
OG0005690	0	1	1	0	2
OG0005691	0	2	0	0	2
OG0005692	0	1	1	0	2
OG0005693	0	2	0	0	2
OG0005694	0	2	0	0	2
OG0005695	0	1	1	0	2
OG0005696	0	2	0	0	2
OG0005697	0	2	0	0	2
OG0005698	0	2	0	0	2
OG0005699	0	1	1	0	2
OG0005700	0	1	1	0	2
OG0005701	0	1	1	0	2
OG0005702	0	2	0	0	2
OG0005703	0	1	1	0	2
OG0005704	0	1	1	0	2
OG0005705	0	1	1	0	2
OG0005706	0	1	1	0	2
OG0005707	0	2	0	0	2
OG0005708	0	2	0	0	2
OG0005709	0	1	1	0	2
OG0005710	0	1	1	0	2
OG0005711	0	1	1	0	2
OG0005712	0	2	0	0	2
OG0005713	0	1	1	0	2
OG0005714	0	1	0	1	2
OG0005715	0	2	0	0	2
OG0005716	0	1	1	0	2
OG0005717	0	1	1	0	2
OG0005718	0	1	1	0	2
OG0005719	0	1	1	0	2
OG0005720	0	1	1	0	2
OG0005721	0	1	1	0	2
OG0005722	0	1	1	0	2
OG0005723	0	1	1	0	2
OG0005724	0	1	1	0	2
OG0005725	0	1	1	0	2
OG0005726	0	1	0	1	2
OG0005727	0	1	1	0	2
OG0005728	0	1	1	0	2
OG0005729	0	1	1	0	2
OG0005730	0	1	1	0	2
OG0005731	0	1	1	0	2
OG0005732	0	1	1	0	2
OG0005733	0	1	1	0	2
OG0005734	0	1	1	0	2
OG0005735	0	1	1	0	2
OG0005736	0	1	1	0	2
OG0005737	0	1	1	0	2
OG0005738	0	1	1	0	2
OG0005739	0	1	1	0	2
OG0005740	0	1	1	0	2
OG0005741	0	1	1	0	2
OG0005742	0	1	1	0	2
OG0005743	0	1	1	0	2
OG0005744	0	2	0	0	2
OG0005745	0	1	1	0	2
OG0005746	0	2	0	0	2
OG0005747	0	2	0	0	2
OG0005748	0	2	0	0	2
OG0005749	0	1	1	0	2
OG0005750	0	2	0	0	2
OG0005751	0	2	0	0	2
OG0005752	0	1	1	0	2
OG0005753	0	1	1	0	2
OG0005754	0	1	1	0	2
OG0005755	0	1	1	0	2
OG0005756	0	1	1	0	2
OG0005757	0	1	1	0	2
OG0005758	0	2	0	0	2
OG0005759	0	1	1	0	2
OG0005760	0	0	2	0	2
OG0005761	0	0	2	0	2
OG0005762	0	0	2	0	2
OG0005763	0	0	2	0	2
OG0005764	0	0	2	0	2
OG0005765	0	0	1	1	2
OG0005766	0	0	2	0	2
OG0005767	0	0	2	0	2
OG0005768	0	0	2	0	2
OG0005769	0	0	1	1	2
OG0005770	0	0	1	1	2
OG0005771	0	0	2	0	2
OG0005772	0	0	1	1	2
OG0005773	0	0	2	0	2
OG0005774	0	0	2	0	2
OG0005775	0	0	2	0	2
OG0005776	0	0	2	0	2
OG0005777	0	0	1	1	2
OG0005778	0	0	2	0	2
OG0005779	0	0	2	0	2
OG0005780	0	0	2	0	2
OG0005781	0	0	2	0	2
OG0005782	0	0	2	0	2
OG0005783	0	0	2	0	2
OG0005784	0	0	2	0	2
OG0005785	0	0	2	0	2
OG0005786	0	0	1	1	2
OG0005787	0	0	2	0	2
OG0005788	0	0	2	0	2
OG0005789	0	0	2	0	2
OG0005790	0	0	2	0	2
OG0005791	0	0	2	0	2
OG0005792	0	0	2	0	2
OG0005793	0	0	2	0	2
OG0005794	0	0	2	0	2
OG0005795	0	0	2	0	2
OG0005796	0	0	2	0	2
OG0005797	0	0	2	0	2
OG0005798	0	0	2	0	2
OG0005799	0	0	2	0	2
OG0005800	0	0	2	0	2
OG0005801	0	0	1	1	2
OG0005802	0	0	2	0	2
OG0005803	0	0	1	1	2
OG0005804	0	0	2	0	2
OG0005805	0	0	2	0	2
OG0005806	0	0	2	0	2
OG0005807	0	0	2	0	2
OG0005808	0	0	1	1	2
OG0005809	0	0	2	0	2
OG0005810	0	0	2	0	2
OG0005811	0	0	1	1	2
OG0005812	0	0	1	1	2
OG0005813	0	0	2	0	2
OG0005814	0	0	2	0	2
OG0005815	0	0	2	0	2
OG0005816	0	0	2	0	2
OG0005817	0	0	2	0	2
OG0005818	0	0	2	0	2
OG0005819	0	0	2	0	2
OG0005820	0	0	2	0	2
OG0005821	0	0	2	0	2
OG0005822	0	0	2	0	2
OG0005823	0	0	2	0	2
OG0005824	0	0	1	1	2
OG0005825	0	0	2	0	2
OG0005826	0	0	1	1	2
OG0005827	0	0	2	0	2
OG0005828	0	0	2	0	2
OG0005829	0	0	2	0	2
OG0005830	0	0	2	0	2
OG0005831	0	0	2	0	2
OG0005832	0	0	2	0	2
OG0005833	0	0	2	0	2
OG0005834	0	0	2	0	2
OG0005835	0	0	2	0	2
OG0005836	0	0	2	0	2
OG0005837	0	0	2	0	2
OG0005838	0	0	2	0	2
OG0005839	0	0	2	0	2
OG0005840	0	0	2	0	2
OG0005841	0	0	2	0	2
OG0005842	0	0	1	1	2
OG0005843	0	0	2	0	2
OG0005844	0	0	2	0	2
OG0005845	0	0	2	0	2
OG0005846	0	0	1	1	2
OG0005847	0	0	2	0	2
OG0005848	0	0	2	0	2
OG0005849	0	0	1	1	2
OG0005850	0	0	2	0	2
OG0005851	0	0	2	0	2
OG0005852	0	0	2	0	2
OG0005853	0	0	1	1	2
OG0005854	0	0	1	1	2
OG0005855	0	0	1	1	2
OG0005856	0	0	2	0	2
OG0005857	0	0	1	1	2
OG0005858	0	0	2	0	2
OG0005859	0	0	2	0	2
OG0005860	0	0	1	1	2
OG0005861	0	0	2	0	2
OG0005862	0	0	2	0	2
OG0005863	0	0	1	1	2
OG0005864	0	0	1	1	2
OG0005865	0	0	2	0	2
OG0005866	0	0	1	1	2
OG0005867	0	0	2	0	2
OG0005868	0	0	2	0	2
OG0005869	0	0	2	0	2
OG0005870	0	0	2	0	2
OG0005871	0	0	2	0	2
OG0005872	0	0	1	1	2
OG0005873	0	0	2	0	2
OG0005874	0	0	1	1	2
OG0005875	0	0	1	1	2
OG0005876	0	0	2	0	2
OG0005877	0	0	1	1	2
OG0005878	0	0	1	1	2
OG0005879	0	0	2	0	2
OG0005880	0	0	2	0	2
OG0005881	0	0	2	0	2
OG0005882	0	0	2	0	2
OG0005883	0	0	2	0	2
OG0005884	0	0	2	0	2
OG0005885	0	0	2	0	2
OG0005886	0	0	2	0	2
OG0005887	0	0	2	0	2
OG0005888	0	0	2	0	2
OG0005889	0	0	2	0	2
OG0005890	0	0	2	0	2
OG0005891	0	0	2	0	2
OG0005892	0	0	2	0	2
OG0005893	0	0	2	0	2
OG0005894	0	0	2	0	2
OG0005895	0	0	1	1	2
OG0005896	0	0	2	0	2
OG0005897	0	0	2	0	2
OG0005898	0	0	2	0	2
OG0005899	0	0	2	0	2
OG0005900	0	0	1	1	2
OG0005901	0	0	1	1	2
OG0005902	0	0	2	0	2
OG0005903	0	0	1	1	2
OG0005904	0	0	1	1	2
OG0005905	0	0	2	0	2
OG0005906	0	0	2	0	2
OG0005907	0	0	2	0	2
OG0005908	0	0	2	0	2
OG0005909	0	0	2	0	2
OG0005910	0	0	2	0	2
OG0005911	0	0	1	1	2
OG0005912	0	0	2	0	2
OG0005913	0	0	2	0	2
OG0005914	0	0	2	0	2
OG0005915	0	0	2	0	2
OG0005916	0	0	2	0	2
OG0005917	0	0	2	0	2
OG0005918	0	0	2	0	2
OG0005919	0	0	2	0	2
OG0005920	0	0	1	1	2
OG0005921	0	0	2	0	2
OG0005922	0	0	2	0	2
OG0005923	0	0	2	0	2
OG0005924	0	0	2	0	2
OG0005925	0	0	1	1	2
OG0005926	0	0	2	0	2
OG0005927	0	0	2	0	2
OG0005928	0	0	1	1	2
OG0005929	0	0	2	0	2
OG0005930	0	0	2	0	2
OG0005931	0	0	2	0	2
OG0005932	0	0	2	0	2
OG0005933	0	0	0	2	2
OG0005934	0	0	0	2	2
OG0005935	0	0	0	2	2
OG0005936	0	0	0	2	2
OG0005937	0	0	0	2	2
OG0005938	0	0	0	2	2
OG0005939	0	0	0	2	2
OG0005940	0	0	0	2	2
OG0005941	0	0	0	2	2
OG0005942	0	0	0	2	2
OG0005943	0	0	0	2	2
OG0005944	0	0	0	2	2
OG0005945	0	0	0	2	2
OG0005946	0	0	0	2	2
OG0005947	0	0	0	2	2
OG0005948	0	0	0	2	2
OG0005949	0	0	0	2	2
OG0005950	0	0	0	2	2
OG0005951	0	0	0	2	2
OG0005952	0	0	0	2	2
OG0005953	0	0	0	2	2
OG0005954	0	0	0	2	2
OG0005955	0	0	0	2	2
OG0005956	0	0	0	2	2
OG0005957	0	0	0	2	2
OG0005958	0	0	0	2	2
OG0005959	0	0	0	2	2
OG0005960	0	0	0	2	2
OG0005961	0	0	0	2	2
OG0005962	0	0	0	2	2
OG0005963	0	0	0	2	2
OG0005964	0	0	0	2	2
OG0005965	0	0	0	2	2
OG0005966	0	0	0	2	2
OG0005967	0	0	0	2	2
OG0005968	0	0	0	2	2
OG0005969	0	0	0	2	2
OG0005970	0	0	0	2	2
OG0005971	0	0	0	2	2
OG0005972	0	0	0	2	2
OG0005973	0	0	0	2	2
OG0005974	0	0	0	2	2
OG0005975	0	0	0	2	2
OG0005976	0	0	0	2	2
OG0005977	0	0	0	2	2
OG0005978	0	0	0	2	2
OG0005979	0	0	0	2	2
OG0005980	0	0	0	2	2
OG0005981	0	0	0	2	2
OG0005982	0	0	0	2	2
OG0005983	0	0	0	2	2
OG0005984	0	0	0	2	2
OG0005985	0	0	0	2	2
OG0005986	0	0	0	2	2
OG0005987	0	0	0	2	2
OG0005988	0	0	0	2	2
OG0005989	0	0	0	2	2
OG0005990	0	0	0	2	2
OG0005991	0	0	0	2	2
OG0005992	0	0	0	2	2
OG0005993	0	0	0	2	2
OG0005994	0	0	0	2	2
OG0005995	0	0	0	2	2
OG0005996	0	0	0	2	2
OG0005997	0	0	0	2	2
OG0005998	0	0	0	2	2
OG0005999	0	0	0	2	2
OG0006000	0	0	0	2	2
OG0006001	0	0	0	2	2
OG0006002	0	0	0	2	2
OG0006003	0	0	0	2	2
OG0006004	0	0	0	2	2
OG0006005	0	0	0	2	2
OG0006006	0	0	0	2	2
OG0006007	0	0	0	2	2
OG0006008	0	0	0	2	2
OG0006009	0	0	0	2	2
OG0006010	0	0	0	2	2
OG0006011	0	0	0	2	2
OG0006012	0	0	0	2	2
OG0006013	0	0	0	2	2
OG0006014	0	0	0	2	2
OG0006015	0	0	0	2	2
OG0006016	0	0	0	2	2
OG0006017	0	0	0	2	2
OG0006018	0	0	0	2	2
OG0006019	0	0	0	2	2
OG0006020	0	0	0	2	2
OG0006021	0	0	0	2	2
OG0006022	0	0	0	2	2
OG0006023	0	0	0	2	2
OG0006024	0	0	0	2	2
OG0006025	0	0	0	2	2
OG0006026	0	0	0	2	2
OG0006027	0	0	0	2	2
OG0006028	0	0	0	2	2
OG0006029	0	0	0	2	2
OG0006030	0	0	0	2	2
OG0006031	0	0	0	2	2
OG0006032	0	0	0	2	2
OG0006033	0	0	0	2	2
OG0006034	0	0	0	2	2
OG0006035	0	0	0	2	2
OG0006036	0	0	0	2	2
OG0006037	0	0	0	2	2
OG0006038	0	0	0	2	2
OG0006039	0	0	0	2	2
OG0006040	0	0	0	2	2
OG0006041	0	0	0	2	2
OG0006042	0	0	0	2	2
OG0006043	0	0	0	2	2
OG0006044	0	0	0	2	2
OG0006045	0	0	0	2	2
OG0006046	0	0	0	2	2
OG0006047	0	0	0	2	2
OG0006048	0	0	0	2	2
OG0006049	0	0	0	2	2
OG0006050	0	0	0	2	2
OG0006051	0	0	0	2	2
OG0006052	0	0	0	2	2
OG0006053	0	0	0	2	2
OG0006054	0	0	0	2	2
