Orthogroup	kog_cerevisiae_pos_go	kog_droso_pos_go	kog_elegans_pos_go	protein_mansoni	Total
OG0000000	0	1	1	111	113
OG0000001	3	15	21	25	64
OG0000002	0	0	0	52	52
OG0000003	0	0	49	0	49
OG0000004	48	0	0	0	48
OG0000005	0	0	46	0	46
OG0000006	0	0	42	0	42
OG0000007	0	1	36	0	37
OG0000008	0	0	34	0	34
OG0000009	0	0	32	0	32
OG0000010	0	0	32	0	32
OG0000011	0	0	0	32	32
OG0000012	5	2	14	9	30
OG0000013	0	0	30	0	30
OG0000014	0	0	0	30	30
OG0000015	0	0	29	0	29
OG0000016	28	0	0	0	28
OG0000017	1	3	17	6	27
OG0000018	0	0	26	1	27
OG0000019	3	8	6	9	26
OG0000020	0	0	26	0	26
OG0000021	0	0	26	0	26
OG0000022	0	21	1	3	25
OG0000023	0	0	25	0	25
OG0000024	1	1	21	1	24
OG0000025	4	2	7	11	24
OG0000026	0	1	0	23	24
OG0000027	2	1	18	2	23
OG0000028	1	1	17	3	22
OG0000029	1	0	0	21	22
OG0000030	0	2	20	0	22
OG0000031	0	0	22	0	22
OG0000032	0	0	22	0	22
OG0000033	0	0	22	0	22
OG0000034	0	0	22	0	22
OG0000035	0	0	0	22	22
OG0000036	0	0	0	22	22
OG0000037	0	0	0	21	21
OG0000038	0	1	17	2	20
OG0000039	0	0	20	0	20
OG0000040	0	0	19	1	20
OG0000041	5	1	11	2	19
OG0000042	0	4	4	11	19
OG0000043	1	14	3	0	18
OG0000044	18	0	0	0	18
OG0000045	0	0	18	0	18
OG0000046	0	0	0	18	18
OG0000047	0	0	0	18	18
OG0000048	2	1	9	5	17
OG0000049	2	15	0	0	17
OG0000050	1	2	3	11	17
OG0000051	1	2	7	7	17
OG0000052	2	4	5	6	17
OG0000053	0	0	17	0	17
OG0000054	0	0	17	0	17
OG0000055	0	0	0	17	17
OG0000056	0	0	0	17	17
OG0000057	1	5	10	0	16
OG0000058	1	2	8	5	16
OG0000059	1	7	2	6	16
OG0000060	0	1	15	0	16
OG0000061	0	3	0	13	16
OG0000062	0	0	16	0	16
OG0000063	0	0	16	0	16
OG0000064	2	3	7	3	15
OG0000065	1	2	8	4	15
OG0000066	5	1	3	6	15
OG0000067	3	1	4	7	15
OG0000068	1	4	8	2	15
OG0000069	4	1	6	3	14
OG0000070	3	2	1	8	14
OG0000071	6	1	4	3	14
OG0000072	1	1	5	7	14
OG0000073	3	2	7	2	14
OG0000074	5	3	1	5	14
OG0000075	3	2	7	2	14
OG0000076	3	0	4	7	14
OG0000077	0	0	3	11	14
OG0000078	0	0	12	2	14
OG0000079	0	0	14	0	14
OG0000080	0	0	0	14	14
OG0000081	2	3	4	4	13
OG0000082	2	3	2	6	13
OG0000083	2	4	3	4	13
OG0000084	2	1	5	5	13
OG0000085	1	3	8	1	13
OG0000086	2	0	10	1	13
OG0000087	1	1	0	11	13
OG0000088	0	4	6	3	13
OG0000089	0	1	1	11	13
OG0000090	0	5	3	5	13
OG0000091	0	0	2	11	13
OG0000092	0	0	0	13	13
OG0000093	0	0	0	13	13
OG0000094	12	0	0	0	12
OG0000095	1	1	10	0	12
OG0000096	1	1	5	5	12
OG0000097	1	5	0	6	12
OG0000098	0	6	2	4	12
OG0000099	0	1	8	3	12
OG0000100	0	1	7	4	12
OG0000101	0	6	5	1	12
OG0000102	0	1	7	4	12
OG0000103	0	0	12	0	12
OG0000104	0	0	12	0	12
OG0000105	0	0	0	12	12
OG0000106	2	1	7	1	11
OG0000107	3	2	5	1	11
OG0000108	2	3	2	4	11
OG0000109	3	1	5	2	11
OG0000110	3	1	2	5	11
OG0000111	0	1	9	1	11
OG0000112	0	1	0	10	11
OG0000113	0	6	5	0	11
OG0000114	0	11	0	0	11
OG0000115	0	0	11	0	11
OG0000116	0	0	1	10	11
OG0000117	0	0	0	11	11
OG0000118	0	0	0	11	11
OG0000119	0	0	0	11	11
OG0000120	0	0	0	11	11
OG0000121	1	0	5	4	10
OG0000122	1	5	1	3	10
OG0000123	3	1	1	5	10
OG0000124	3	2	2	3	10
OG0000125	1	0	8	1	10
OG0000126	4	2	1	3	10
OG0000127	1	1	7	1	10
OG0000128	3	4	1	2	10
OG0000129	3	1	2	4	10
OG0000130	1	0	9	0	10
OG0000131	2	0	3	5	10
OG0000132	2	3	2	3	10
OG0000133	5	1	1	3	10
OG0000134	0	1	2	7	10
OG0000135	0	1	6	3	10
OG0000136	0	9	1	0	10
OG0000137	0	1	8	1	10
OG0000138	0	2	6	2	10
OG0000139	0	1	3	6	10
OG0000140	0	4	2	4	10
OG0000141	0	0	9	1	10
OG0000142	0	0	10	0	10
OG0000143	0	0	8	2	10
OG0000144	0	0	10	0	10
OG0000145	0	0	0	10	10
OG0000146	0	0	0	10	10
OG0000147	0	0	0	10	10
OG0000148	0	0	0	10	10
OG0000149	1	1	2	5	9
OG0000150	2	1	3	3	9
OG0000151	2	1	5	1	9
OG0000152	1	1	1	6	9
OG0000153	3	1	1	4	9
OG0000154	1	1	1	6	9
OG0000155	1	1	4	3	9
OG0000156	2	2	1	4	9
OG0000157	1	1	5	2	9
OG0000158	1	2	4	2	9
OG0000159	3	2	2	2	9
OG0000160	1	0	0	8	9
OG0000161	1	0	7	1	9
OG0000162	2	2	1	4	9
OG0000163	1	1	4	3	9
OG0000164	2	0	5	2	9
OG0000165	3	0	6	0	9
OG0000166	3	0	3	3	9
OG0000167	1	0	1	7	9
OG0000168	2	0	4	3	9
OG0000169	3	2	2	2	9
OG0000170	3	1	1	4	9
OG0000171	1	1	6	1	9
OG0000172	0	1	6	2	9
OG0000173	0	1	8	0	9
OG0000174	0	1	3	5	9
OG0000175	0	0	9	0	9
OG0000176	0	0	9	0	9
OG0000177	0	0	9	0	9
OG0000178	0	0	1	8	9
OG0000179	0	0	9	0	9
OG0000180	0	0	9	0	9
OG0000181	0	0	9	0	9
OG0000182	0	0	9	0	9
OG0000183	0	0	0	9	9
OG0000184	0	0	0	9	9
OG0000185	0	0	0	9	9
OG0000186	0	0	0	9	9
OG0000187	0	0	0	9	9
OG0000188	0	0	0	9	9
OG0000189	0	0	0	9	9
OG0000190	0	0	0	9	9
OG0000191	0	0	0	9	9
OG0000192	8	0	0	0	8
OG0000193	2	2	3	1	8
OG0000194	1	2	5	0	8
OG0000195	1	2	2	3	8
OG0000196	2	3	2	1	8
OG0000197	1	0	2	5	8
OG0000198	8	0	0	0	8
OG0000199	3	1	2	2	8
OG0000200	1	1	2	4	8
OG0000201	1	1	1	5	8
OG0000202	2	1	1	4	8
OG0000203	6	1	1	0	8
OG0000204	1	2	1	4	8
OG0000205	1	1	2	4	8
OG0000206	3	1	1	3	8
OG0000207	3	2	1	2	8
OG0000208	1	1	2	4	8
OG0000209	3	1	1	3	8
OG0000210	2	1	2	3	8
OG0000211	2	0	1	5	8
OG0000212	2	3	1	2	8
OG0000213	3	0	2	3	8
OG0000214	3	1	2	2	8
OG0000215	3	1	1	3	8
OG0000216	1	0	4	3	8
OG0000217	1	0	2	5	8
OG0000218	1	0	3	4	8
OG0000219	1	1	3	3	8
OG0000220	2	1	2	3	8
OG0000221	2	1	1	4	8
OG0000222	1	2	2	3	8
OG0000223	1	1	3	3	8
OG0000224	1	0	6	1	8
OG0000225	5	1	1	1	8
OG0000226	1	2	2	3	8
OG0000227	0	1	7	0	8
OG0000228	0	1	1	6	8
OG0000229	0	1	1	6	8
OG0000230	0	1	1	6	8
OG0000231	0	2	4	2	8
OG0000232	0	3	2	3	8
OG0000233	0	1	2	5	8
OG0000234	0	2	3	3	8
OG0000235	0	7	0	1	8
OG0000236	0	2	2	4	8
OG0000237	0	6	1	1	8
OG0000238	0	0	8	0	8
OG0000239	0	0	8	0	8
OG0000240	0	0	6	2	8
OG0000241	0	0	4	4	8
OG0000242	0	0	8	0	8
OG0000243	0	0	1	7	8
OG0000244	0	0	8	0	8
OG0000245	0	0	8	0	8
OG0000246	0	0	8	0	8
OG0000247	0	0	8	0	8
OG0000248	0	0	8	0	8
OG0000249	0	0	0	8	8
OG0000250	0	0	0	8	8
OG0000251	0	0	0	8	8
OG0000252	0	0	0	8	8
OG0000253	0	0	0	8	8
OG0000254	3	2	1	1	7
OG0000255	2	1	1	3	7
OG0000256	2	0	3	2	7
OG0000257	1	0	1	5	7
OG0000258	2	1	2	2	7
OG0000259	7	0	0	0	7
OG0000260	3	1	1	2	7
OG0000261	1	1	1	4	7
OG0000262	1	1	1	4	7
OG0000263	3	1	1	2	7
OG0000264	1	3	1	2	7
OG0000265	2	1	3	1	7
OG0000266	3	0	1	3	7
OG0000267	2	1	2	2	7
OG0000268	1	2	2	2	7
OG0000269	2	0	2	3	7
OG0000270	2	2	0	3	7
OG0000271	3	1	1	2	7
OG0000272	2	2	1	2	7
OG0000273	1	1	3	2	7
OG0000274	1	0	2	4	7
OG0000275	1	5	1	0	7
OG0000276	2	0	3	2	7
OG0000277	1	1	4	1	7
OG0000278	2	0	1	4	7
OG0000279	1	3	1	2	7
OG0000280	2	2	2	1	7
OG0000281	2	1	3	1	7
OG0000282	3	0	1	3	7
OG0000283	2	1	1	3	7
OG0000284	1	1	3	2	7
OG0000285	1	0	1	5	7
OG0000286	1	2	2	2	7
OG0000287	2	1	1	3	7
OG0000288	2	1	2	2	7
OG0000289	1	0	4	2	7
OG0000290	7	0	0	0	7
OG0000291	2	0	3	2	7
OG0000292	2	0	1	4	7
OG0000293	2	2	2	1	7
OG0000294	1	1	4	1	7
OG0000295	1	2	2	2	7
OG0000296	3	0	4	0	7
OG0000297	1	1	2	3	7
OG0000298	1	2	1	3	7
OG0000299	1	2	2	2	7
OG0000300	2	0	2	3	7
OG0000301	1	0	4	2	7
OG0000302	1	1	3	2	7
OG0000303	3	0	3	1	7
OG0000304	0	1	1	5	7
OG0000305	0	3	1	3	7
OG0000306	0	3	2	2	7
OG0000307	0	2	3	2	7
OG0000308	0	1	1	5	7
OG0000309	0	3	2	2	7
OG0000310	0	2	2	3	7
OG0000311	0	1	2	4	7
OG0000312	0	2	1	4	7
OG0000313	0	1	1	5	7
OG0000314	0	1	1	5	7
OG0000315	0	7	0	0	7
OG0000316	0	1	3	3	7
OG0000317	0	1	3	3	7
OG0000318	0	1	5	1	7
OG0000319	0	2	4	1	7
OG0000320	0	2	2	3	7
OG0000321	0	3	3	1	7
OG0000322	0	0	3	4	7
OG0000323	0	0	1	6	7
OG0000324	0	0	7	0	7
OG0000325	0	0	7	0	7
OG0000326	0	0	1	6	7
OG0000327	0	0	6	1	7
OG0000328	0	0	7	0	7
OG0000329	0	0	7	0	7
OG0000330	0	0	7	0	7
OG0000331	0	0	7	0	7
OG0000332	0	0	0	7	7
OG0000333	0	0	0	7	7
OG0000334	0	0	0	7	7
OG0000335	0	0	0	7	7
OG0000336	0	0	0	7	7
OG0000337	0	0	0	7	7
OG0000338	0	0	0	7	7
OG0000339	4	0	2	0	6
OG0000340	1	2	2	1	6
OG0000341	2	1	1	2	6
OG0000342	1	1	2	2	6
OG0000343	1	0	4	1	6
OG0000344	2	1	2	1	6
OG0000345	2	2	1	1	6
OG0000346	1	1	3	1	6
OG0000347	2	1	1	2	6
OG0000348	3	1	0	2	6
OG0000349	6	0	0	0	6
OG0000350	2	1	1	2	6
OG0000351	2	1	2	1	6
OG0000352	2	1	1	2	6
OG0000353	1	1	2	2	6
OG0000354	1	2	2	1	6
OG0000355	2	1	1	2	6
OG0000356	3	0	1	2	6
OG0000357	2	1	1	2	6
OG0000358	1	2	1	2	6
OG0000359	1	2	2	1	6
OG0000360	1	1	4	0	6
OG0000361	1	1	2	2	6
OG0000362	1	1	3	1	6
OG0000363	2	0	2	2	6
OG0000364	2	1	2	1	6
OG0000365	1	1	1	3	6
OG0000366	1	1	2	2	6
OG0000367	1	0	3	2	6
OG0000368	2	1	2	1	6
OG0000369	2	3	1	0	6
OG0000370	2	2	1	1	6
OG0000371	1	2	2	1	6
OG0000372	2	1	1	2	6
OG0000373	2	0	3	1	6
OG0000374	2	2	1	1	6
OG0000375	2	1	2	1	6
OG0000376	2	0	3	1	6
OG0000377	6	0	0	0	6
OG0000378	1	1	2	2	6
OG0000379	2	0	1	3	6
OG0000380	2	2	1	1	6
OG0000381	4	1	0	1	6
OG0000382	1	1	2	2	6
OG0000383	1	2	2	1	6
OG0000384	2	1	2	1	6
OG0000385	1	1	1	3	6
OG0000386	1	1	1	3	6
OG0000387	1	0	2	3	6
OG0000388	1	1	3	1	6
OG0000389	3	0	2	1	6
OG0000390	3	0	2	1	6
OG0000391	2	1	2	1	6
OG0000392	1	1	1	3	6
OG0000393	1	2	2	1	6
OG0000394	2	1	2	1	6
OG0000395	3	0	1	2	6
OG0000396	1	1	2	2	6
OG0000397	1	1	2	2	6
OG0000398	2	1	1	2	6
OG0000399	1	0	4	1	6
OG0000400	1	0	4	1	6
OG0000401	2	1	2	1	6
OG0000402	2	1	1	2	6
OG0000403	1	0	2	3	6
OG0000404	6	0	0	0	6
OG0000405	1	1	2	2	6
OG0000406	3	1	1	1	6
OG0000407	1	0	3	2	6
OG0000408	2	0	2	2	6
OG0000409	2	1	1	2	6
OG0000410	1	1	3	1	6
OG0000411	1	0	3	2	6
OG0000412	2	1	1	2	6
OG0000413	2	1	1	2	6
OG0000414	1	1	0	4	6
OG0000415	1	0	2	3	6
OG0000416	5	0	0	1	6
OG0000417	1	1	2	2	6
OG0000418	1	0	3	2	6
OG0000419	4	0	1	1	6
OG0000420	0	1	1	4	6
OG0000421	0	2	2	2	6
OG0000422	0	2	4	0	6
OG0000423	0	2	2	2	6
OG0000424	0	1	1	4	6
OG0000425	0	2	2	2	6
OG0000426	0	2	3	1	6
OG0000427	0	1	2	3	6
OG0000428	0	1	4	1	6
OG0000429	0	3	2	1	6
OG0000430	0	1	2	3	6
OG0000431	0	1	0	5	6
OG0000432	0	3	2	1	6
OG0000433	0	2	3	1	6
OG0000434	0	1	0	5	6
OG0000435	0	5	1	0	6
OG0000436	0	1	2	3	6
OG0000437	0	3	1	2	6
OG0000438	0	1	2	3	6
OG0000439	0	3	3	0	6
OG0000440	0	2	1	3	6
OG0000441	0	1	1	4	6
OG0000442	0	4	1	1	6
OG0000443	0	1	4	1	6
OG0000444	0	1	4	1	6
OG0000445	0	1	5	0	6
OG0000446	0	0	1	5	6
OG0000447	0	0	5	1	6
OG0000448	0	0	6	0	6
OG0000449	0	0	6	0	6
OG0000450	0	0	6	0	6
OG0000451	0	0	5	1	6
OG0000452	0	0	6	0	6
OG0000453	0	0	6	0	6
OG0000454	0	0	6	0	6
OG0000455	0	0	6	0	6
OG0000456	0	0	6	0	6
OG0000457	0	0	1	5	6
OG0000458	0	0	6	0	6
OG0000459	0	0	6	0	6
OG0000460	0	0	6	0	6
OG0000461	0	0	4	2	6
OG0000462	0	0	6	0	6
OG0000463	0	0	6	0	6
OG0000464	0	0	0	6	6
OG0000465	0	0	0	6	6
OG0000466	0	0	0	6	6
OG0000467	0	0	0	6	6
OG0000468	0	0	0	6	6
OG0000469	0	0	0	6	6
OG0000470	0	0	0	6	6
OG0000471	0	0	0	6	6
OG0000472	0	0	0	6	6
OG0000473	2	1	1	1	5
OG0000474	1	2	2	0	5
OG0000475	1	1	0	3	5
OG0000476	1	1	1	2	5
OG0000477	1	2	1	1	5
OG0000478	1	1	2	1	5
OG0000479	2	1	1	1	5
OG0000480	1	1	1	2	5
OG0000481	1	2	1	1	5
OG0000482	2	0	2	1	5
OG0000483	1	2	1	1	5
OG0000484	2	1	1	1	5
OG0000485	1	0	2	2	5
OG0000486	1	1	1	2	5
OG0000487	2	0	1	2	5
OG0000488	1	1	2	1	5
OG0000489	1	2	1	1	5
OG0000490	2	1	1	1	5
OG0000491	1	1	1	2	5
OG0000492	1	0	1	3	5
OG0000493	1	1	1	2	5
OG0000494	1	1	1	2	5
OG0000495	1	2	1	1	5
OG0000496	2	1	1	1	5
OG0000497	2	0	1	2	5
OG0000498	2	0	1	2	5
OG0000499	2	0	1	2	5
OG0000500	1	1	1	2	5
OG0000501	2	1	1	1	5
OG0000502	2	1	1	1	5
OG0000503	1	2	1	1	5
OG0000504	1	0	3	1	5
OG0000505	1	0	1	3	5
OG0000506	2	1	1	1	5
OG0000507	1	1	1	2	5
OG0000508	1	0	1	3	5
OG0000509	5	0	0	0	5
OG0000510	2	2	0	1	5
OG0000511	1	1	1	2	5
OG0000512	1	0	2	2	5
OG0000513	1	2	1	1	5
OG0000514	1	1	1	2	5
OG0000515	1	0	4	0	5
OG0000516	1	0	0	4	5
OG0000517	1	1	1	2	5
OG0000518	2	1	1	1	5
OG0000519	1	1	1	2	5
OG0000520	2	1	1	1	5
OG0000521	1	1	2	1	5
OG0000522	1	1	2	1	5
OG0000523	1	2	1	1	5
OG0000524	1	0	2	2	5
OG0000525	1	0	3	1	5
OG0000526	1	1	0	3	5
OG0000527	1	1	1	2	5
OG0000528	1	2	1	1	5
OG0000529	1	1	3	0	5
OG0000530	1	1	2	1	5
OG0000531	2	1	1	1	5
OG0000532	2	1	1	1	5
OG0000533	2	1	1	1	5
OG0000534	1	1	1	2	5
OG0000535	1	1	2	1	5
OG0000536	1	1	1	2	5
OG0000537	2	0	1	2	5
OG0000538	2	1	1	1	5
OG0000539	1	0	2	2	5
OG0000540	2	1	1	1	5
OG0000541	2	0	1	2	5
OG0000542	1	0	3	1	5
OG0000543	1	0	1	3	5
OG0000544	2	0	2	1	5
OG0000545	1	0	1	3	5
OG0000546	2	0	1	2	5
OG0000547	5	0	0	0	5
OG0000548	1	1	1	2	5
OG0000549	1	0	1	3	5
OG0000550	1	1	2	1	5
OG0000551	1	1	2	1	5
OG0000552	1	2	1	1	5
OG0000553	1	1	2	1	5
OG0000554	1	2	2	0	5
OG0000555	1	1	2	1	5
OG0000556	1	0	2	2	5
OG0000557	2	0	2	1	5
OG0000558	2	0	1	2	5
OG0000559	3	0	1	1	5
OG0000560	5	0	0	0	5
OG0000561	2	0	2	1	5
OG0000562	1	0	2	2	5
OG0000563	2	1	1	1	5
OG0000564	1	0	3	1	5
OG0000565	1	1	0	3	5
OG0000566	1	1	2	1	5
OG0000567	5	0	0	0	5
OG0000568	2	1	1	1	5
OG0000569	2	1	1	1	5
OG0000570	2	1	1	1	5
OG0000571	1	1	3	0	5
OG0000572	1	1	2	1	5
OG0000573	1	1	1	2	5
OG0000574	1	0	2	2	5
OG0000575	1	1	1	2	5
OG0000576	2	0	0	3	5
OG0000577	2	1	1	1	5
OG0000578	2	0	2	1	5
OG0000579	1	1	1	2	5
OG0000580	2	1	1	1	5
OG0000581	2	0	1	2	5
OG0000582	1	2	1	1	5
OG0000583	1	1	2	1	5
OG0000584	1	1	1	2	5
OG0000585	1	1	2	1	5
OG0000586	1	1	1	2	5
OG0000587	1	1	2	1	5
OG0000588	1	2	1	1	5
OG0000589	2	1	1	1	5
OG0000590	2	0	1	2	5
OG0000591	1	0	3	1	5
OG0000592	1	2	1	1	5
OG0000593	1	1	1	2	5
OG0000594	1	0	1	3	5
OG0000595	1	1	1	2	5
OG0000596	1	1	2	1	5
OG0000597	1	1	1	2	5
OG0000598	1	2	1	1	5
OG0000599	2	1	1	1	5
OG0000600	1	1	1	2	5
OG0000601	1	1	1	2	5
OG0000602	2	1	1	1	5
OG0000603	2	0	1	2	5
OG0000604	1	1	1	2	5
OG0000605	2	0	1	2	5
OG0000606	1	0	3	1	5
OG0000607	1	1	1	2	5
OG0000608	2	1	1	1	5
OG0000609	1	1	1	2	5
OG0000610	2	1	1	1	5
OG0000611	2	1	1	1	5
OG0000612	2	1	1	1	5
OG0000613	1	1	1	2	5
OG0000614	2	0	2	1	5
OG0000615	2	1	1	1	5
OG0000616	2	0	1	2	5
OG0000617	1	1	1	2	5
OG0000618	2	1	1	1	5
OG0000619	1	1	1	2	5
OG0000620	1	1	2	1	5
OG0000621	1	1	1	2	5
OG0000622	1	1	1	2	5
OG0000623	1	0	3	1	5
OG0000624	3	1	0	1	5
OG0000625	1	2	0	2	5
OG0000626	2	1	1	1	5
OG0000627	1	2	1	1	5
OG0000628	1	1	1	2	5
OG0000629	1	1	1	2	5
OG0000630	1	1	1	2	5
OG0000631	2	1	1	1	5
OG0000632	2	1	1	1	5
OG0000633	2	1	1	1	5
OG0000634	2	1	1	1	5
OG0000635	2	1	1	1	5
OG0000636	2	2	0	1	5
OG0000637	2	1	1	1	5
OG0000638	2	0	2	1	5
OG0000639	2	1	1	1	5
OG0000640	1	0	1	3	5
OG0000641	1	1	2	1	5
OG0000642	1	2	0	2	5
OG0000643	1	1	2	1	5
OG0000644	2	1	1	1	5
OG0000645	5	0	0	0	5
OG0000646	0	1	3	1	5
OG0000647	0	5	0	0	5
OG0000648	0	1	4	0	5
OG0000649	0	1	2	2	5
OG0000650	0	2	2	1	5
OG0000651	0	2	2	1	5
OG0000652	0	1	3	1	5
OG0000653	0	1	0	4	5
OG0000654	0	1	2	2	5
OG0000655	0	1	2	2	5
OG0000656	0	1	1	3	5
OG0000657	0	1	4	0	5
OG0000658	0	1	3	1	5
OG0000659	0	1	2	2	5
OG0000660	0	1	1	3	5
OG0000661	0	2	0	3	5
OG0000662	0	1	3	1	5
OG0000663	0	1	1	3	5
OG0000664	0	1	3	1	5
OG0000665	0	1	3	1	5
OG0000666	0	1	4	0	5
OG0000667	0	1	3	1	5
OG0000668	0	1	1	3	5
OG0000669	0	1	2	2	5
OG0000670	0	1	1	3	5
OG0000671	0	1	0	4	5
OG0000672	0	1	2	2	5
OG0000673	0	2	1	2	5
OG0000674	0	1	3	1	5
OG0000675	0	1	1	3	5
OG0000676	0	3	0	2	5
OG0000677	0	1	3	1	5
OG0000678	0	2	1	2	5
OG0000679	0	4	0	1	5
OG0000680	0	2	2	1	5
OG0000681	0	2	2	1	5
OG0000682	0	5	0	0	5
OG0000683	0	2	0	3	5
OG0000684	0	2	3	0	5
OG0000685	0	2	2	1	5
OG0000686	0	1	3	1	5
OG0000687	0	1	3	1	5
OG0000688	0	3	1	1	5
OG0000689	0	1	1	3	5
OG0000690	0	2	2	1	5
OG0000691	0	4	1	0	5
OG0000692	0	1	3	1	5
OG0000693	0	1	2	2	5
OG0000694	0	2	0	3	5
OG0000695	0	1	2	2	5
OG0000696	0	5	0	0	5
OG0000697	0	0	1	4	5
OG0000698	0	0	5	0	5
OG0000699	0	0	1	4	5
OG0000700	0	0	1	4	5
OG0000701	0	0	4	1	5
OG0000702	0	0	3	2	5
OG0000703	0	0	5	0	5
OG0000704	0	0	5	0	5
OG0000705	0	0	5	0	5
OG0000706	0	0	5	0	5
OG0000707	0	0	5	0	5
OG0000708	0	0	5	0	5
OG0000709	0	0	5	0	5
OG0000710	0	0	5	0	5
OG0000711	0	0	4	1	5
OG0000712	0	0	5	0	5
OG0000713	0	0	2	3	5
OG0000714	0	0	5	0	5
OG0000715	0	0	4	1	5
OG0000716	0	0	3	2	5
OG0000717	0	0	5	0	5
OG0000718	0	0	3	2	5
OG0000719	0	0	4	1	5
OG0000720	0	0	3	2	5
OG0000721	0	0	3	2	5
OG0000722	0	0	1	4	5
OG0000723	0	0	5	0	5
OG0000724	0	0	3	2	5
OG0000725	0	0	3	2	5
OG0000726	0	0	3	2	5
OG0000727	0	0	2	3	5
OG0000728	0	0	5	0	5
OG0000729	0	0	4	1	5
OG0000730	0	0	5	0	5
OG0000731	0	0	5	0	5
OG0000732	0	0	4	1	5
OG0000733	0	0	2	3	5
OG0000734	0	0	4	1	5
OG0000735	0	0	4	1	5
OG0000736	0	0	5	0	5
OG0000737	0	0	5	0	5
OG0000738	0	0	0	5	5
OG0000739	0	0	0	5	5
OG0000740	0	0	0	5	5
OG0000741	0	0	0	5	5
OG0000742	0	0	0	5	5
OG0000743	0	0	0	5	5
OG0000744	0	0	0	5	5
OG0000745	0	0	0	5	5
OG0000746	0	0	0	5	5
OG0000747	0	0	0	5	5
OG0000748	0	0	0	5	5
OG0000749	0	0	0	5	5
OG0000750	0	0	0	5	5
OG0000751	0	0	0	5	5
OG0000752	0	0	0	5	5
OG0000753	0	0	0	5	5
OG0000754	0	0	0	5	5
OG0000755	0	0	0	5	5
OG0000756	0	0	0	5	5
OG0000757	0	0	0	5	5
OG0000758	0	0	0	5	5
OG0000759	1	1	1	1	4
OG0000760	1	1	1	1	4
OG0000761	2	0	1	1	4
OG0000762	1	1	1	1	4
OG0000763	1	0	1	2	4
OG0000764	2	0	1	1	4
OG0000765	1	0	1	2	4
OG0000766	1	0	0	3	4
OG0000767	4	0	0	0	4
OG0000768	1	2	1	0	4
OG0000769	1	1	1	1	4
OG0000770	1	1	1	1	4
OG0000771	1	1	1	1	4
OG0000772	2	0	1	1	4
OG0000773	1	1	1	1	4
OG0000774	2	0	1	1	4
OG0000775	1	1	1	1	4
OG0000776	1	0	2	1	4
OG0000777	1	1	1	1	4
OG0000778	1	1	1	1	4
OG0000779	1	1	1	1	4
OG0000780	1	1	1	1	4
OG0000781	1	1	1	1	4
OG0000782	1	1	1	1	4
OG0000783	1	1	1	1	4
OG0000784	1	0	2	1	4
OG0000785	4	0	0	0	4
OG0000786	4	0	0	0	4
OG0000787	2	0	0	2	4
OG0000788	1	1	1	1	4
OG0000789	1	0	1	2	4
OG0000790	1	1	0	2	4
OG0000791	1	1	1	1	4
OG0000792	1	2	0	1	4
OG0000793	1	0	2	1	4
OG0000794	2	0	1	1	4
OG0000795	1	0	2	1	4
OG0000796	1	1	1	1	4
OG0000797	1	1	1	1	4
OG0000798	1	2	0	1	4
OG0000799	1	1	1	1	4
OG0000800	1	1	1	1	4
OG0000801	1	1	1	1	4
OG0000802	1	0	2	1	4
OG0000803	1	1	1	1	4
OG0000804	1	1	1	1	4
OG0000805	1	1	1	1	4
OG0000806	1	1	1	1	4
OG0000807	1	1	1	1	4
OG0000808	1	1	1	1	4
OG0000809	1	1	1	1	4
OG0000810	2	1	0	1	4
OG0000811	1	1	1	1	4
OG0000812	1	1	1	1	4
OG0000813	1	1	1	1	4
OG0000814	1	1	1	1	4
OG0000815	1	0	1	2	4
OG0000816	1	0	2	1	4
OG0000817	1	0	1	2	4
OG0000818	1	1	1	1	4
OG0000819	1	0	0	3	4
OG0000820	1	0	1	2	4
OG0000821	4	0	0	0	4
OG0000822	2	0	1	1	4
OG0000823	1	0	2	1	4
OG0000824	1	0	2	1	4
OG0000825	1	1	1	1	4
OG0000826	1	1	1	1	4
OG0000827	1	1	1	1	4
OG0000828	1	0	2	1	4
OG0000829	1	1	1	1	4
OG0000830	1	0	1	2	4
OG0000831	1	0	1	2	4
OG0000832	1	1	1	1	4
OG0000833	2	0	1	1	4
OG0000834	1	0	1	2	4
OG0000835	1	1	1	1	4
OG0000836	1	1	1	1	4
OG0000837	1	1	1	1	4
OG0000838	1	1	1	1	4
OG0000839	1	1	1	1	4
OG0000840	1	1	1	1	4
OG0000841	3	0	1	0	4
OG0000842	1	0	1	2	4
OG0000843	1	1	1	1	4
OG0000844	1	1	1	1	4
OG0000845	2	0	1	1	4
OG0000846	1	1	0	2	4
OG0000847	1	1	1	1	4
OG0000848	1	1	1	1	4
OG0000849	1	1	1	1	4
OG0000850	2	0	1	1	4
OG0000851	2	1	1	0	4
OG0000852	2	0	1	1	4
OG0000853	1	1	1	1	4
OG0000854	1	1	1	1	4
OG0000855	1	1	1	1	4
OG0000856	2	0	1	1	4
OG0000857	2	0	1	1	4
OG0000858	1	1	1	1	4
OG0000859	1	1	1	1	4
OG0000860	2	0	1	1	4
OG0000861	1	1	1	1	4
OG0000862	1	2	1	0	4
OG0000863	1	1	1	1	4
OG0000864	1	1	1	1	4
OG0000865	1	1	1	1	4
OG0000866	3	0	0	1	4
OG0000867	1	1	1	1	4
OG0000868	2	0	1	1	4
OG0000869	1	1	1	1	4
OG0000870	1	1	1	1	4
OG0000871	1	1	1	1	4
OG0000872	2	1	0	1	4
OG0000873	1	1	1	1	4
OG0000874	1	1	1	1	4
OG0000875	1	1	1	1	4
OG0000876	2	0	1	1	4
OG0000877	1	0	1	2	4
OG0000878	1	1	1	1	4
OG0000879	1	0	2	1	4
OG0000880	1	0	1	2	4
OG0000881	1	0	2	1	4
OG0000882	3	0	0	1	4
OG0000883	1	0	1	2	4
OG0000884	3	0	0	1	4
OG0000885	1	0	2	1	4
OG0000886	1	0	2	1	4
OG0000887	2	1	0	1	4
OG0000888	1	1	0	2	4
OG0000889	1	1	1	1	4
OG0000890	1	0	2	1	4
OG0000891	1	0	1	2	4
OG0000892	1	0	1	2	4
OG0000893	1	0	0	3	4
OG0000894	1	1	1	1	4
OG0000895	1	0	1	2	4
OG0000896	1	1	1	1	4
OG0000897	4	0	0	0	4
OG0000898	1	0	1	2	4
OG0000899	1	0	1	2	4
OG0000900	1	1	1	1	4
OG0000901	4	0	0	0	4
OG0000902	1	0	1	2	4
OG0000903	1	1	1	1	4
OG0000904	2	0	1	1	4
OG0000905	1	0	2	1	4
OG0000906	1	1	1	1	4
OG0000907	1	0	3	0	4
OG0000908	1	1	1	1	4
OG0000909	1	0	2	1	4
OG0000910	1	1	1	1	4
OG0000911	2	0	1	1	4
OG0000912	1	1	1	1	4
OG0000913	1	1	1	1	4
OG0000914	1	1	0	2	4
OG0000915	1	0	1	2	4
OG0000916	1	0	1	2	4
OG0000917	1	1	0	2	4
OG0000918	1	0	1	2	4
OG0000919	1	0	2	1	4
OG0000920	1	0	2	1	4
OG0000921	1	1	1	1	4
OG0000922	1	1	1	1	4
OG0000923	1	1	1	1	4
OG0000924	1	1	1	1	4
OG0000925	1	1	1	1	4
OG0000926	1	1	1	1	4
OG0000927	1	0	2	1	4
OG0000928	1	1	1	1	4
OG0000929	2	0	1	1	4
OG0000930	1	1	1	1	4
OG0000931	1	1	1	1	4
OG0000932	1	0	3	0	4
OG0000933	2	0	1	1	4
OG0000934	1	1	1	1	4
OG0000935	1	1	0	2	4
OG0000936	1	1	1	1	4
OG0000937	1	0	2	1	4
OG0000938	1	1	1	1	4
OG0000939	1	1	1	1	4
OG0000940	2	0	1	1	4
OG0000941	1	0	1	2	4
OG0000942	1	1	1	1	4
OG0000943	1	1	1	1	4
OG0000944	1	1	1	1	4
OG0000945	1	1	1	1	4
OG0000946	1	1	1	1	4
OG0000947	1	0	1	2	4
OG0000948	1	1	1	1	4
OG0000949	1	1	1	1	4
OG0000950	1	1	1	1	4
OG0000951	2	1	0	1	4
OG0000952	1	1	1	1	4
OG0000953	1	1	1	1	4
OG0000954	1	1	1	1	4
OG0000955	1	1	1	1	4
OG0000956	2	0	1	1	4
OG0000957	1	1	1	1	4
OG0000958	1	2	0	1	4
OG0000959	1	0	2	1	4
OG0000960	1	1	1	1	4
OG0000961	1	1	1	1	4
OG0000962	1	1	1	1	4
OG0000963	4	0	0	0	4
OG0000964	1	0	2	1	4
OG0000965	2	0	1	1	4
OG0000966	2	0	1	1	4
OG0000967	1	0	1	2	4
OG0000968	1	0	0	3	4
OG0000969	1	1	1	1	4
OG0000970	1	1	1	1	4
OG0000971	2	1	1	0	4
OG0000972	2	1	0	1	4
OG0000973	1	1	1	1	4
OG0000974	1	1	1	1	4
OG0000975	2	1	0	1	4
OG0000976	2	1	0	1	4
OG0000977	1	1	1	1	4
OG0000978	1	1	1	1	4
OG0000979	1	0	2	1	4
OG0000980	2	0	1	1	4
OG0000981	1	1	1	1	4
OG0000982	1	1	1	1	4
OG0000983	1	1	1	1	4
OG0000984	1	1	1	1	4
OG0000985	1	1	1	1	4
OG0000986	1	1	1	1	4
OG0000987	1	0	2	1	4
OG0000988	1	0	2	1	4
OG0000989	1	0	2	1	4
OG0000990	1	0	0	3	4
OG0000991	2	1	0	1	4
OG0000992	2	0	1	1	4
OG0000993	2	0	1	1	4
OG0000994	1	1	1	1	4
OG0000995	1	0	2	1	4
OG0000996	2	0	1	1	4
OG0000997	1	0	1	2	4
OG0000998	1	1	1	1	4
OG0000999	1	1	1	1	4
OG0001000	2	1	0	1	4
OG0001001	1	0	0	3	4
OG0001002	1	1	1	1	4
OG0001003	1	1	1	1	4
OG0001004	1	1	1	1	4
OG0001005	1	0	1	2	4
OG0001006	1	1	1	1	4
OG0001007	1	1	1	1	4
OG0001008	1	1	1	1	4
OG0001009	1	0	1	2	4
OG0001010	1	1	1	1	4
OG0001011	1	1	1	1	4
OG0001012	4	0	0	0	4
OG0001013	1	0	1	2	4
OG0001014	1	1	1	1	4
OG0001015	1	1	1	1	4
OG0001016	1	0	1	2	4
OG0001017	1	0	1	2	4
OG0001018	1	1	1	1	4
OG0001019	1	0	2	1	4
OG0001020	1	1	1	1	4
OG0001021	1	1	1	1	4
OG0001022	1	1	1	1	4
OG0001023	1	1	1	1	4
OG0001024	1	1	1	1	4
OG0001025	2	1	0	1	4
OG0001026	1	1	1	1	4
OG0001027	1	1	1	1	4
OG0001028	1	0	2	1	4
OG0001029	1	1	1	1	4
OG0001030	1	1	1	1	4
OG0001031	1	1	1	1	4
OG0001032	2	0	1	1	4
OG0001033	1	0	0	3	4
OG0001034	1	0	2	1	4
OG0001035	1	1	1	1	4
OG0001036	1	1	1	1	4
OG0001037	1	1	2	0	4
OG0001038	1	1	1	1	4
OG0001039	1	1	1	1	4
OG0001040	1	1	1	1	4
OG0001041	1	1	1	1	4
OG0001042	1	1	1	1	4
OG0001043	1	1	1	1	4
OG0001044	1	0	2	1	4
OG0001045	1	0	1	2	4
OG0001046	1	1	1	1	4
OG0001047	1	1	1	1	4
OG0001048	1	0	2	1	4
OG0001049	1	0	3	0	4
OG0001050	2	0	1	1	4
OG0001051	1	1	1	1	4
OG0001052	1	0	2	1	4
OG0001053	1	1	1	1	4
OG0001054	1	1	1	1	4
OG0001055	1	0	2	1	4
OG0001056	1	1	1	1	4
OG0001057	1	1	1	1	4
OG0001058	2	0	1	1	4
OG0001059	1	1	1	1	4
OG0001060	1	2	0	1	4
OG0001061	1	1	1	1	4
OG0001062	1	1	1	1	4
OG0001063	1	1	1	1	4
OG0001064	1	1	1	1	4
OG0001065	1	0	0	3	4
OG0001066	1	1	2	0	4
OG0001067	1	0	1	2	4
OG0001068	1	1	1	1	4
OG0001069	1	0	1	2	4
OG0001070	1	1	1	1	4
OG0001071	1	1	1	1	4
OG0001072	1	1	1	1	4
OG0001073	1	0	2	1	4
OG0001074	1	1	1	1	4
OG0001075	1	0	0	3	4
OG0001076	2	0	1	1	4
OG0001077	1	1	1	1	4
OG0001078	1	1	1	1	4
OG0001079	1	1	1	1	4
OG0001080	2	0	1	1	4
OG0001081	1	1	1	1	4
OG0001082	1	1	0	2	4
OG0001083	1	1	1	1	4
OG0001084	1	1	1	1	4
OG0001085	1	1	1	1	4
OG0001086	1	1	1	1	4
OG0001087	1	1	1	1	4
OG0001088	1	1	2	0	4
OG0001089	1	1	1	1	4
OG0001090	1	1	1	1	4
OG0001091	1	1	1	1	4
OG0001092	1	1	1	1	4
OG0001093	1	1	1	1	4
OG0001094	1	0	2	1	4
OG0001095	1	1	1	1	4
OG0001096	1	1	1	1	4
OG0001097	1	0	2	1	4
OG0001098	1	0	1	2	4
OG0001099	1	1	1	1	4
OG0001100	1	1	1	1	4
OG0001101	1	1	1	1	4
OG0001102	1	1	0	2	4
OG0001103	4	0	0	0	4
OG0001104	1	1	1	1	4
OG0001105	1	1	1	1	4
OG0001106	1	1	1	1	4
OG0001107	1	0	1	2	4
OG0001108	1	1	1	1	4
OG0001109	1	2	0	1	4
OG0001110	1	1	1	1	4
OG0001111	1	1	1	1	4
OG0001112	1	0	1	2	4
OG0001113	1	1	1	1	4
OG0001114	1	1	1	1	4
OG0001115	1	2	0	1	4
OG0001116	1	1	1	1	4
OG0001117	1	1	1	1	4
OG0001118	1	1	0	2	4
OG0001119	1	1	1	1	4
OG0001120	1	1	1	1	4
OG0001121	2	1	0	1	4
OG0001122	1	1	1	1	4
OG0001123	2	0	1	1	4
OG0001124	1	1	1	1	4
OG0001125	2	0	1	1	4
OG0001126	1	1	1	1	4
OG0001127	1	1	1	1	4
OG0001128	1	1	1	1	4
OG0001129	1	0	1	2	4
OG0001130	1	1	1	1	4
OG0001131	1	1	1	1	4
OG0001132	2	1	0	1	4
OG0001133	1	1	1	1	4
OG0001134	1	1	1	1	4
OG0001135	2	1	0	1	4
OG0001136	2	0	1	1	4
OG0001137	2	0	1	1	4
OG0001138	1	1	1	1	4
OG0001139	1	0	1	2	4
OG0001140	1	1	1	1	4
OG0001141	2	0	1	1	4
OG0001142	2	1	1	0	4
OG0001143	2	1	0	1	4
OG0001144	1	1	1	1	4
OG0001145	1	1	1	1	4
OG0001146	2	0	1	1	4
OG0001147	1	1	1	1	4
OG0001148	2	1	0	1	4
OG0001149	1	1	1	1	4
OG0001150	1	1	1	1	4
OG0001151	1	1	1	1	4
OG0001152	2	1	0	1	4
OG0001153	1	1	1	1	4
OG0001154	1	1	1	1	4
OG0001155	1	0	1	2	4
OG0001156	1	1	1	1	4
OG0001157	1	0	1	2	4
OG0001158	1	1	1	1	4
OG0001159	1	1	2	0	4
OG0001160	1	1	1	1	4
OG0001161	1	1	0	2	4
OG0001162	1	0	2	1	4
OG0001163	1	1	1	1	4
OG0001164	1	1	1	1	4
OG0001165	1	1	2	0	4
OG0001166	1	1	1	1	4
OG0001167	1	1	0	2	4
OG0001168	1	0	1	2	4
OG0001169	1	1	1	1	4
OG0001170	1	1	1	1	4
OG0001171	1	0	2	1	4
OG0001172	1	1	1	1	4
OG0001173	2	0	1	1	4
OG0001174	1	2	1	0	4
OG0001175	1	1	1	1	4
OG0001176	2	0	0	2	4
OG0001177	1	0	2	1	4
OG0001178	1	0	1	2	4
OG0001179	4	0	0	0	4
OG0001180	0	2	2	0	4
OG0001181	0	2	1	1	4
OG0001182	0	1	1	2	4
OG0001183	0	1	1	2	4
OG0001184	0	1	1	2	4
OG0001185	0	1	2	1	4
OG0001186	0	1	2	1	4
OG0001187	0	1	1	2	4
OG0001188	0	1	1	2	4
OG0001189	0	1	1	2	4
OG0001190	0	1	2	1	4
OG0001191	0	1	2	1	4
OG0001192	0	1	2	1	4
OG0001193	0	1	1	2	4
OG0001194	0	1	1	2	4
OG0001195	0	2	1	1	4
OG0001196	0	1	2	1	4
OG0001197	0	2	1	1	4
OG0001198	0	2	1	1	4
OG0001199	0	1	1	2	4
OG0001200	0	2	1	1	4
OG0001201	0	1	1	2	4
OG0001202	0	1	3	0	4
OG0001203	0	2	1	1	4
OG0001204	0	1	2	1	4
OG0001205	0	1	2	1	4
OG0001206	0	1	2	1	4
OG0001207	0	1	2	1	4
OG0001208	0	1	1	2	4
OG0001209	0	1	2	1	4
OG0001210	0	1	1	2	4
OG0001211	0	1	2	1	4
OG0001212	0	2	1	1	4
OG0001213	0	1	1	2	4
OG0001214	0	2	1	1	4
OG0001215	0	1	1	2	4
OG0001216	0	1	2	1	4
OG0001217	0	1	2	1	4
OG0001218	0	2	1	1	4
OG0001219	0	1	3	0	4
OG0001220	0	1	1	2	4
OG0001221	0	1	1	2	4
OG0001222	0	3	1	0	4
OG0001223	0	4	0	0	4
OG0001224	0	1	2	1	4
OG0001225	0	1	0	3	4
OG0001226	0	2	1	1	4
OG0001227	0	2	1	1	4
OG0001228	0	2	1	1	4
OG0001229	0	2	1	1	4
OG0001230	0	1	2	1	4
OG0001231	0	1	2	1	4
OG0001232	0	1	2	1	4
OG0001233	0	1	0	3	4
OG0001234	0	1	1	2	4
OG0001235	0	1	1	2	4
OG0001236	0	1	1	2	4
OG0001237	0	2	1	1	4
OG0001238	0	1	2	1	4
OG0001239	0	1	2	1	4
OG0001240	0	1	1	2	4
OG0001241	0	1	1	2	4
OG0001242	0	1	1	2	4
OG0001243	0	1	1	2	4
OG0001244	0	1	2	1	4
OG0001245	0	1	2	1	4
OG0001246	0	1	1	2	4
OG0001247	0	1	2	1	4
OG0001248	0	2	1	1	4
OG0001249	0	1	2	1	4
OG0001250	0	1	2	1	4
OG0001251	0	1	2	1	4
OG0001252	0	2	1	1	4
OG0001253	0	1	3	0	4
OG0001254	0	1	1	2	4
OG0001255	0	1	1	2	4
OG0001256	0	1	1	2	4
OG0001257	0	1	1	2	4
OG0001258	0	1	2	1	4
OG0001259	0	0	4	0	4
OG0001260	0	0	1	3	4
OG0001261	0	0	3	1	4
OG0001262	0	0	2	2	4
OG0001263	0	0	4	0	4
OG0001264	0	0	4	0	4
OG0001265	0	0	4	0	4
OG0001266	0	0	3	1	4
OG0001267	0	0	4	0	4
OG0001268	0	0	1	3	4
OG0001269	0	0	4	0	4
OG0001270	0	0	2	2	4
OG0001271	0	0	4	0	4
OG0001272	0	0	4	0	4
OG0001273	0	0	4	0	4
OG0001274	0	0	2	2	4
OG0001275	0	0	4	0	4
OG0001276	0	0	2	2	4
OG0001277	0	0	4	0	4
OG0001278	0	0	4	0	4
OG0001279	0	0	1	3	4
OG0001280	0	0	1	3	4
OG0001281	0	0	4	0	4
OG0001282	0	0	4	0	4
OG0001283	0	0	3	1	4
OG0001284	0	0	4	0	4
OG0001285	0	0	3	1	4
OG0001286	0	0	2	2	4
OG0001287	0	0	2	2	4
OG0001288	0	0	3	1	4
OG0001289	0	0	1	3	4
OG0001290	0	0	4	0	4
OG0001291	0	0	2	2	4
OG0001292	0	0	3	1	4
OG0001293	0	0	3	1	4
OG0001294	0	0	4	0	4
OG0001295	0	0	2	2	4
OG0001296	0	0	4	0	4
OG0001297	0	0	1	3	4
OG0001298	0	0	4	0	4
OG0001299	0	0	4	0	4
OG0001300	0	0	4	0	4
OG0001301	0	0	4	0	4
OG0001302	0	0	4	0	4
OG0001303	0	0	4	0	4
OG0001304	0	0	3	1	4
OG0001305	0	0	4	0	4
OG0001306	0	0	4	0	4
OG0001307	0	0	4	0	4
OG0001308	0	0	4	0	4
OG0001309	0	0	3	1	4
OG0001310	0	0	4	0	4
OG0001311	0	0	2	2	4
OG0001312	0	0	2	2	4
OG0001313	0	0	1	3	4
OG0001314	0	0	3	1	4
OG0001315	0	0	4	0	4
OG0001316	0	0	3	1	4
OG0001317	0	0	4	0	4
OG0001318	0	0	4	0	4
OG0001319	0	0	4	0	4
OG0001320	0	0	1	3	4
OG0001321	0	0	0	4	4
OG0001322	0	0	0	4	4
OG0001323	0	0	0	4	4
OG0001324	0	0	0	4	4
OG0001325	0	0	0	4	4
OG0001326	0	0	0	4	4
OG0001327	0	0	0	4	4
OG0001328	0	0	0	4	4
OG0001329	0	0	0	4	4
OG0001330	0	0	0	4	4
OG0001331	0	0	0	4	4
OG0001332	0	0	0	4	4
OG0001333	0	0	0	4	4
OG0001334	0	0	0	4	4
OG0001335	0	0	0	4	4
OG0001336	0	0	0	4	4
OG0001337	0	0	0	4	4
OG0001338	0	0	0	4	4
OG0001339	0	0	0	4	4
OG0001340	0	0	0	4	4
OG0001341	0	0	0	4	4
OG0001342	0	0	0	4	4
OG0001343	0	0	0	4	4
OG0001344	0	0	0	4	4
OG0001345	0	0	0	4	4
OG0001346	0	0	0	4	4
OG0001347	0	0	0	4	4
OG0001348	0	0	0	4	4
OG0001349	0	0	0	4	4
OG0001350	0	0	0	4	4
OG0001351	0	0	0	4	4
OG0001352	0	0	0	4	4
OG0001353	0	0	0	4	4
OG0001354	0	0	0	4	4
OG0001355	0	0	0	4	4
OG0001356	0	0	0	4	4
OG0001357	0	0	0	4	4
OG0001358	0	0	0	4	4
OG0001359	0	0	0	4	4
OG0001360	0	0	0	4	4
OG0001361	0	0	0	4	4
OG0001362	0	0	0	4	4
OG0001363	0	0	0	4	4
OG0001364	0	0	0	4	4
OG0001365	0	0	0	4	4
OG0001366	0	0	0	4	4
OG0001367	1	0	0	2	3
OG0001368	1	0	1	1	3
OG0001369	3	0	0	0	3
OG0001370	3	0	0	0	3
OG0001371	1	1	0	1	3
OG0001372	1	0	1	1	3
OG0001373	3	0	0	0	3
OG0001374	1	1	1	0	3
OG0001375	1	0	1	1	3
OG0001376	3	0	0	0	3
OG0001377	1	0	1	1	3
OG0001378	1	0	2	0	3
OG0001379	1	0	1	1	3
OG0001380	1	0	1	1	3
OG0001381	1	0	1	1	3
OG0001382	1	0	1	1	3
OG0001383	1	1	0	1	3
OG0001384	1	0	1	1	3
OG0001385	1	1	0	1	3
OG0001386	1	1	0	1	3
OG0001387	1	0	1	1	3
OG0001388	1	1	1	0	3
OG0001389	1	0	1	1	3
OG0001390	1	0	1	1	3
OG0001391	1	0	1	1	3
OG0001392	1	1	0	1	3
OG0001393	1	0	1	1	3
OG0001394	1	0	1	1	3
OG0001395	1	0	1	1	3
OG0001396	1	0	1	1	3
OG0001397	1	0	1	1	3
OG0001398	1	0	1	1	3
OG0001399	1	1	0	1	3
OG0001400	1	0	0	2	3
OG0001401	1	0	1	1	3
OG0001402	1	0	1	1	3
OG0001403	1	0	1	1	3
OG0001404	1	0	1	1	3
OG0001405	1	0	1	1	3
OG0001406	1	0	1	1	3
OG0001407	1	0	1	1	3
OG0001408	1	1	1	0	3
OG0001409	1	1	1	0	3
OG0001410	3	0	0	0	3
OG0001411	1	1	0	1	3
OG0001412	1	0	1	1	3
OG0001413	1	0	1	1	3
OG0001414	1	0	1	1	3
OG0001415	1	0	0	2	3
OG0001416	1	1	0	1	3
OG0001417	2	0	0	1	3
OG0001418	1	1	0	1	3
OG0001419	1	0	1	1	3
OG0001420	1	0	1	1	3
OG0001421	1	1	0	1	3
OG0001422	1	0	1	1	3
OG0001423	1	0	1	1	3
OG0001424	1	1	0	1	3
OG0001425	1	0	1	1	3
OG0001426	1	0	1	1	3
OG0001427	1	0	1	1	3
OG0001428	1	0	1	1	3
OG0001429	1	1	0	1	3
OG0001430	1	0	1	1	3
OG0001431	1	1	0	1	3
OG0001432	1	0	1	1	3
OG0001433	1	1	0	1	3
OG0001434	1	0	1	1	3
OG0001435	1	0	1	1	3
OG0001436	1	0	1	1	3
OG0001437	1	0	1	1	3
OG0001438	1	1	0	1	3
OG0001439	1	1	0	1	3
OG0001440	1	0	1	1	3
OG0001441	1	1	0	1	3
OG0001442	1	0	1	1	3
OG0001443	1	0	1	1	3
OG0001444	1	0	1	1	3
OG0001445	1	0	1	1	3
OG0001446	1	0	1	1	3
OG0001447	1	1	0	1	3
OG0001448	1	1	0	1	3
OG0001449	1	0	1	1	3
OG0001450	1	0	0	2	3
OG0001451	1	0	1	1	3
OG0001452	1	0	0	2	3
OG0001453	1	1	0	1	3
OG0001454	1	0	1	1	3
OG0001455	1	0	1	1	3
OG0001456	1	0	1	1	3
OG0001457	1	1	0	1	3
OG0001458	1	0	1	1	3
OG0001459	1	1	0	1	3
OG0001460	1	0	1	1	3
OG0001461	1	0	1	1	3
OG0001462	1	0	1	1	3
OG0001463	1	0	2	0	3
OG0001464	1	1	0	1	3
OG0001465	1	0	1	1	3
OG0001466	1	0	1	1	3
OG0001467	1	0	1	1	3
OG0001468	1	0	1	1	3
OG0001469	2	0	1	0	3
OG0001470	1	1	1	0	3
OG0001471	1	0	1	1	3
OG0001472	1	0	1	1	3
OG0001473	3	0	0	0	3
OG0001474	1	0	1	1	3
OG0001475	1	0	0	2	3
OG0001476	1	0	1	1	3
OG0001477	1	0	1	1	3
OG0001478	1	0	1	1	3
OG0001479	1	1	1	0	3
OG0001480	1	0	1	1	3
OG0001481	1	0	1	1	3
OG0001482	1	0	1	1	3
OG0001483	1	0	1	1	3
OG0001484	1	0	1	1	3
OG0001485	1	0	1	1	3
OG0001486	1	0	1	1	3
OG0001487	1	0	1	1	3
OG0001488	1	1	0	1	3
OG0001489	1	0	1	1	3
OG0001490	1	1	0	1	3
OG0001491	1	0	0	2	3
OG0001492	1	0	1	1	3
OG0001493	1	0	1	1	3
OG0001494	1	0	1	1	3
OG0001495	1	0	1	1	3
OG0001496	1	0	1	1	3
OG0001497	1	1	0	1	3
OG0001498	1	0	1	1	3
OG0001499	1	1	0	1	3
OG0001500	1	1	0	1	3
OG0001501	1	0	1	1	3
OG0001502	2	1	0	0	3
OG0001503	1	0	1	1	3
OG0001504	1	1	0	1	3
OG0001505	1	0	1	1	3
OG0001506	1	0	1	1	3
OG0001507	1	1	0	1	3
OG0001508	2	0	0	1	3
OG0001509	1	0	1	1	3
OG0001510	1	0	1	1	3
OG0001511	1	1	0	1	3
OG0001512	1	0	1	1	3
OG0001513	1	0	1	1	3
OG0001514	1	0	1	1	3
OG0001515	1	1	0	1	3
OG0001516	1	0	0	2	3
OG0001517	1	0	1	1	3
OG0001518	1	0	1	1	3
OG0001519	1	0	1	1	3
OG0001520	1	0	1	1	3
OG0001521	1	0	1	1	3
OG0001522	2	0	1	0	3
OG0001523	1	0	1	1	3
OG0001524	1	1	0	1	3
OG0001525	1	0	1	1	3
OG0001526	1	0	1	1	3
OG0001527	1	0	2	0	3
OG0001528	1	0	0	2	3
OG0001529	1	1	0	1	3
OG0001530	1	1	0	1	3
OG0001531	1	1	0	1	3
OG0001532	1	0	1	1	3
OG0001533	1	0	1	1	3
OG0001534	2	0	0	1	3
OG0001535	1	0	1	1	3
OG0001536	1	0	1	1	3
OG0001537	1	0	1	1	3
OG0001538	1	1	0	1	3
OG0001539	1	1	0	1	3
OG0001540	1	0	1	1	3
OG0001541	1	1	0	1	3
OG0001542	1	0	1	1	3
OG0001543	1	0	1	1	3
OG0001544	1	0	1	1	3
OG0001545	2	1	0	0	3
OG0001546	1	0	1	1	3
OG0001547	1	1	0	1	3
OG0001548	1	0	1	1	3
OG0001549	1	0	1	1	3
OG0001550	2	0	0	1	3
OG0001551	1	0	1	1	3
OG0001552	1	0	1	1	3
OG0001553	1	0	1	1	3
OG0001554	1	0	1	1	3
OG0001555	1	0	1	1	3
OG0001556	1	0	1	1	3
OG0001557	1	0	1	1	3
OG0001558	3	0	0	0	3
OG0001559	1	1	1	0	3
OG0001560	1	0	1	1	3
OG0001561	1	1	0	1	3
OG0001562	1	1	1	0	3
OG0001563	1	0	1	1	3
OG0001564	1	0	1	1	3
OG0001565	1	0	0	2	3
OG0001566	1	0	1	1	3
OG0001567	1	1	0	1	3
OG0001568	1	0	1	1	3
OG0001569	2	0	1	0	3
OG0001570	1	1	1	0	3
OG0001571	1	0	1	1	3
OG0001572	1	0	1	1	3
OG0001573	3	0	0	0	3
OG0001574	1	0	1	1	3
OG0001575	1	0	1	1	3
OG0001576	1	0	1	1	3
OG0001577	1	1	0	1	3
OG0001578	3	0	0	0	3
OG0001579	1	0	1	1	3
OG0001580	1	0	1	1	3
OG0001581	1	0	1	1	3
OG0001582	1	0	1	1	3
OG0001583	1	1	0	1	3
OG0001584	1	1	0	1	3
OG0001585	1	1	0	1	3
OG0001586	1	0	1	1	3
OG0001587	1	0	1	1	3
OG0001588	1	0	1	1	3
OG0001589	1	0	1	1	3
OG0001590	1	0	1	1	3
OG0001591	1	0	1	1	3
OG0001592	1	0	1	1	3
OG0001593	1	0	1	1	3
OG0001594	1	0	1	1	3
OG0001595	1	1	0	1	3
OG0001596	1	0	1	1	3
OG0001597	1	1	0	1	3
OG0001598	1	0	1	1	3
OG0001599	1	1	0	1	3
OG0001600	1	0	0	2	3
OG0001601	1	0	1	1	3
OG0001602	2	0	1	0	3
OG0001603	2	0	0	1	3
OG0001604	1	0	1	1	3
OG0001605	1	0	1	1	3
OG0001606	1	1	0	1	3
OG0001607	2	0	0	1	3
OG0001608	1	0	1	1	3
OG0001609	1	0	1	1	3
OG0001610	1	0	1	1	3
OG0001611	1	0	1	1	3
OG0001612	3	0	0	0	3
OG0001613	1	0	1	1	3
OG0001614	1	0	2	0	3
OG0001615	1	0	1	1	3
OG0001616	1	0	1	1	3
OG0001617	1	0	1	1	3
OG0001618	1	0	1	1	3
OG0001619	1	0	1	1	3
OG0001620	1	0	1	1	3
OG0001621	2	0	0	1	3
OG0001622	1	0	1	1	3
OG0001623	1	1	0	1	3
OG0001624	3	0	0	0	3
OG0001625	1	0	1	1	3
OG0001626	1	0	2	0	3
OG0001627	1	0	1	1	3
OG0001628	1	0	1	1	3
OG0001629	1	0	1	1	3
OG0001630	1	0	1	1	3
OG0001631	1	0	1	1	3
OG0001632	1	1	0	1	3
OG0001633	1	0	1	1	3
OG0001634	1	0	1	1	3
OG0001635	3	0	0	0	3
OG0001636	1	0	1	1	3
OG0001637	1	0	1	1	3
OG0001638	1	1	0	1	3
OG0001639	1	0	1	1	3
OG0001640	3	0	0	0	3
OG0001641	3	0	0	0	3
OG0001642	1	0	1	1	3
OG0001643	1	0	0	2	3
OG0001644	1	0	1	1	3
OG0001645	1	0	1	1	3
OG0001646	3	0	0	0	3
OG0001647	1	1	0	1	3
OG0001648	1	0	1	1	3
OG0001649	1	1	0	1	3
OG0001650	2	0	0	1	3
OG0001651	2	0	0	1	3
OG0001652	1	1	0	1	3
OG0001653	1	0	1	1	3
OG0001654	1	0	1	1	3
OG0001655	1	0	1	1	3
OG0001656	1	0	1	1	3
OG0001657	1	0	1	1	3
OG0001658	1	0	1	1	3
OG0001659	1	0	1	1	3
OG0001660	2	0	0	1	3
OG0001661	1	0	1	1	3
OG0001662	1	0	1	1	3
OG0001663	2	0	1	0	3
OG0001664	3	0	0	0	3
OG0001665	1	0	1	1	3
OG0001666	1	0	1	1	3
OG0001667	1	0	1	1	3
OG0001668	1	0	1	1	3
OG0001669	1	0	1	1	3
OG0001670	1	0	1	1	3
OG0001671	1	0	1	1	3
OG0001672	1	0	1	1	3
OG0001673	1	1	0	1	3
OG0001674	1	0	1	1	3
OG0001675	1	0	1	1	3
OG0001676	1	1	0	1	3
OG0001677	1	0	1	1	3
OG0001678	2	0	0	1	3
OG0001679	1	0	1	1	3
OG0001680	1	0	1	1	3
OG0001681	1	0	1	1	3
OG0001682	1	0	1	1	3
OG0001683	3	0	0	0	3
OG0001684	1	0	1	1	3
OG0001685	1	1	0	1	3
OG0001686	1	0	1	1	3
OG0001687	1	1	0	1	3
OG0001688	1	0	1	1	3
OG0001689	1	0	1	1	3
OG0001690	1	0	1	1	3
OG0001691	1	0	1	1	3
OG0001692	1	0	1	1	3
OG0001693	1	0	1	1	3
OG0001694	1	0	1	1	3
OG0001695	1	0	1	1	3
OG0001696	1	1	0	1	3
OG0001697	1	0	1	1	3
OG0001698	1	0	1	1	3
OG0001699	1	0	1	1	3
OG0001700	1	0	1	1	3
OG0001701	1	0	1	1	3
OG0001702	1	0	1	1	3
OG0001703	1	0	1	1	3
OG0001704	1	0	1	1	3
OG0001705	1	0	1	1	3
OG0001706	1	0	1	1	3
OG0001707	1	0	1	1	3
OG0001708	1	0	1	1	3
OG0001709	1	0	1	1	3
OG0001710	1	0	1	1	3
OG0001711	1	0	1	1	3
OG0001712	1	0	1	1	3
OG0001713	1	0	1	1	3
OG0001714	1	0	1	1	3
OG0001715	1	1	0	1	3
OG0001716	1	0	1	1	3
OG0001717	1	1	0	1	3
OG0001718	1	0	0	2	3
OG0001719	1	0	1	1	3
OG0001720	1	1	0	1	3
OG0001721	1	0	1	1	3
OG0001722	1	1	0	1	3
OG0001723	2	0	0	1	3
OG0001724	1	0	1	1	3
OG0001725	1	0	1	1	3
OG0001726	1	0	1	1	3
OG0001727	1	0	1	1	3
OG0001728	1	1	0	1	3
OG0001729	1	0	1	1	3
OG0001730	1	0	1	1	3
OG0001731	1	0	1	1	3
OG0001732	1	1	1	0	3
OG0001733	1	0	1	1	3
OG0001734	1	1	0	1	3
OG0001735	1	0	1	1	3
OG0001736	1	0	1	1	3
OG0001737	3	0	0	0	3
OG0001738	1	1	0	1	3
OG0001739	1	0	1	1	3
OG0001740	1	0	1	1	3
OG0001741	1	0	1	1	3
OG0001742	1	0	1	1	3
OG0001743	1	0	1	1	3
OG0001744	1	0	1	1	3
OG0001745	1	0	1	1	3
OG0001746	1	0	1	1	3
OG0001747	1	1	0	1	3
OG0001748	1	0	1	1	3
OG0001749	1	0	1	1	3
OG0001750	1	1	0	1	3
OG0001751	1	1	1	0	3
OG0001752	1	0	2	0	3
OG0001753	1	0	1	1	3
OG0001754	2	0	1	0	3
OG0001755	1	0	1	1	3
OG0001756	1	1	0	1	3
OG0001757	2	0	1	0	3
OG0001758	1	1	0	1	3
OG0001759	1	0	1	1	3
OG0001760	1	0	1	1	3
OG0001761	1	1	1	0	3
OG0001762	1	0	1	1	3
OG0001763	1	1	0	1	3
OG0001764	1	0	1	1	3
OG0001765	1	0	1	1	3
OG0001766	1	0	1	1	3
OG0001767	1	0	1	1	3
OG0001768	1	0	1	1	3
OG0001769	3	0	0	0	3
OG0001770	1	1	1	0	3
OG0001771	2	0	1	0	3
OG0001772	1	0	1	1	3
OG0001773	1	0	1	1	3
OG0001774	1	0	1	1	3
OG0001775	1	0	1	1	3
OG0001776	1	0	1	1	3
OG0001777	1	1	0	1	3
OG0001778	1	0	1	1	3
OG0001779	1	0	1	1	3
OG0001780	1	1	0	1	3
OG0001781	1	1	0	1	3
OG0001782	1	0	1	1	3
OG0001783	2	0	1	0	3
OG0001784	1	0	1	1	3
OG0001785	1	1	0	1	3
OG0001786	1	0	1	1	3
OG0001787	1	0	1	1	3
OG0001788	1	1	0	1	3
OG0001789	1	0	1	1	3
OG0001790	1	1	0	1	3
OG0001791	1	0	1	1	3
OG0001792	1	1	0	1	3
OG0001793	1	0	1	1	3
OG0001794	1	1	0	1	3
OG0001795	1	0	1	1	3
OG0001796	1	0	1	1	3
OG0001797	1	0	1	1	3
OG0001798	1	0	1	1	3
OG0001799	1	0	1	1	3
OG0001800	1	0	1	1	3
OG0001801	1	1	0	1	3
OG0001802	1	1	0	1	3
OG0001803	1	1	0	1	3
OG0001804	1	0	1	1	3
OG0001805	1	0	1	1	3
OG0001806	1	1	0	1	3
OG0001807	1	0	1	1	3
OG0001808	1	0	1	1	3
OG0001809	1	0	1	1	3
OG0001810	1	1	0	1	3
OG0001811	2	0	1	0	3
OG0001812	1	1	0	1	3
OG0001813	1	0	1	1	3
OG0001814	1	1	0	1	3
OG0001815	1	1	1	0	3
OG0001816	1	0	1	1	3
OG0001817	1	0	1	1	3
OG0001818	1	0	1	1	3
OG0001819	1	0	1	1	3
OG0001820	1	0	1	1	3
OG0001821	1	0	1	1	3
OG0001822	1	0	1	1	3
OG0001823	1	1	1	0	3
OG0001824	1	0	0	2	3
OG0001825	1	0	1	1	3
OG0001826	1	0	1	1	3
OG0001827	1	1	0	1	3
OG0001828	1	0	1	1	3
OG0001829	1	0	1	1	3
OG0001830	1	1	1	0	3
OG0001831	1	0	1	1	3
OG0001832	1	1	0	1	3
OG0001833	1	1	0	1	3
OG0001834	1	0	1	1	3
OG0001835	1	1	0	1	3
OG0001836	1	0	1	1	3
OG0001837	1	1	0	1	3
OG0001838	1	0	1	1	3
OG0001839	1	0	1	1	3
OG0001840	1	0	1	1	3
OG0001841	1	1	0	1	3
OG0001842	1	0	1	1	3
OG0001843	1	0	1	1	3
OG0001844	1	0	1	1	3
OG0001845	1	0	1	1	3
OG0001846	1	0	1	1	3
OG0001847	1	0	1	1	3
OG0001848	1	0	2	0	3
OG0001849	1	0	1	1	3
OG0001850	2	0	0	1	3
OG0001851	1	0	1	1	3
OG0001852	1	0	1	1	3
OG0001853	1	0	1	1	3
OG0001854	1	0	1	1	3
OG0001855	1	0	1	1	3
OG0001856	1	1	1	0	3
OG0001857	1	0	1	1	3
OG0001858	1	0	1	1	3
OG0001859	1	0	1	1	3
OG0001860	1	0	1	1	3
OG0001861	1	0	1	1	3
OG0001862	1	0	1	1	3
OG0001863	1	0	1	1	3
OG0001864	1	0	1	1	3
OG0001865	1	0	2	0	3
OG0001866	1	0	1	1	3
OG0001867	1	0	1	1	3
OG0001868	1	1	0	1	3
OG0001869	1	0	1	1	3
OG0001870	1	1	1	0	3
OG0001871	1	0	1	1	3
OG0001872	1	1	0	1	3
OG0001873	1	1	0	1	3
OG0001874	1	0	1	1	3
OG0001875	1	0	0	2	3
OG0001876	1	0	1	1	3
OG0001877	1	0	1	1	3
OG0001878	1	1	0	1	3
OG0001879	1	0	1	1	3
OG0001880	1	0	1	1	3
OG0001881	1	0	1	1	3
OG0001882	3	0	0	0	3
OG0001883	1	0	1	1	3
OG0001884	1	0	1	1	3
OG0001885	1	0	1	1	3
OG0001886	2	0	0	1	3
OG0001887	1	0	1	1	3
OG0001888	1	0	1	1	3
OG0001889	1	0	1	1	3
OG0001890	1	0	1	1	3
OG0001891	1	0	1	1	3
OG0001892	1	1	0	1	3
OG0001893	1	1	0	1	3
OG0001894	1	0	1	1	3
OG0001895	1	0	1	1	3
OG0001896	1	0	1	1	3
OG0001897	1	0	1	1	3
OG0001898	2	0	0	1	3
OG0001899	1	0	1	1	3
OG0001900	1	0	1	1	3
OG0001901	1	0	1	1	3
OG0001902	1	0	1	1	3
OG0001903	1	0	1	1	3
OG0001904	1	0	1	1	3
OG0001905	1	0	1	1	3
OG0001906	1	0	1	1	3
OG0001907	1	0	1	1	3
OG0001908	1	0	1	1	3
OG0001909	1	1	1	0	3
OG0001910	1	1	0	1	3
OG0001911	1	0	1	1	3
OG0001912	1	0	1	1	3
OG0001913	1	0	1	1	3
OG0001914	1	0	1	1	3
OG0001915	1	0	1	1	3
OG0001916	1	0	1	1	3
OG0001917	1	0	1	1	3
OG0001918	1	0	1	1	3
OG0001919	1	0	1	1	3
OG0001920	2	0	0	1	3
OG0001921	1	1	0	1	3
OG0001922	1	0	1	1	3
OG0001923	1	0	1	1	3
OG0001924	1	0	1	1	3
OG0001925	1	0	1	1	3
OG0001926	1	1	0	1	3
OG0001927	1	0	1	1	3
OG0001928	1	0	1	1	3
OG0001929	1	0	1	1	3
OG0001930	1	0	1	1	3
OG0001931	1	1	0	1	3
OG0001932	1	0	1	1	3
OG0001933	1	0	1	1	3
OG0001934	1	1	0	1	3
OG0001935	1	0	0	2	3
OG0001936	1	0	2	0	3
OG0001937	1	0	1	1	3
OG0001938	1	1	0	1	3
OG0001939	1	1	0	1	3
OG0001940	1	0	1	1	3
OG0001941	1	0	1	1	3
OG0001942	2	0	0	1	3
OG0001943	1	1	0	1	3
OG0001944	1	1	0	1	3
OG0001945	1	0	1	1	3
OG0001946	1	0	1	1	3
OG0001947	1	0	1	1	3
OG0001948	1	0	1	1	3
OG0001949	1	1	1	0	3
OG0001950	1	1	0	1	3
OG0001951	1	1	0	1	3
OG0001952	1	1	0	1	3
OG0001953	1	0	1	1	3
OG0001954	1	0	1	1	3
OG0001955	1	0	1	1	3
OG0001956	1	0	1	1	3
OG0001957	1	1	0	1	3
OG0001958	1	0	1	1	3
OG0001959	1	1	0	1	3
OG0001960	1	0	1	1	3
OG0001961	1	0	1	1	3
OG0001962	1	0	1	1	3
OG0001963	1	0	1	1	3
OG0001964	1	0	1	1	3
OG0001965	1	0	1	1	3
OG0001966	1	0	1	1	3
OG0001967	1	0	1	1	3
OG0001968	1	0	1	1	3
OG0001969	1	0	1	1	3
OG0001970	1	1	1	0	3
OG0001971	3	0	0	0	3
OG0001972	1	0	1	1	3
OG0001973	1	1	0	1	3
OG0001974	1	1	0	1	3
OG0001975	1	0	1	1	3
OG0001976	1	0	1	1	3
OG0001977	1	0	1	1	3
OG0001978	2	0	0	1	3
OG0001979	1	1	1	0	3
OG0001980	1	0	0	2	3
OG0001981	1	0	1	1	3
OG0001982	1	1	1	0	3
OG0001983	1	0	1	1	3
OG0001984	1	0	1	1	3
OG0001985	1	0	1	1	3
OG0001986	1	1	0	1	3
OG0001987	1	0	1	1	3
OG0001988	2	0	0	1	3
OG0001989	1	0	1	1	3
OG0001990	1	0	0	2	3
OG0001991	1	0	1	1	3
OG0001992	1	1	0	1	3
OG0001993	1	1	0	1	3
OG0001994	1	1	0	1	3
OG0001995	1	0	1	1	3
OG0001996	1	0	1	1	3
OG0001997	1	0	1	1	3
OG0001998	1	1	0	1	3
OG0001999	3	0	0	0	3
OG0002000	1	0	1	1	3
OG0002001	1	1	0	1	3
OG0002002	1	0	1	1	3
OG0002003	2	0	0	1	3
OG0002004	1	0	1	1	3
OG0002005	1	0	1	1	3
OG0002006	1	0	1	1	3
OG0002007	2	0	0	1	3
OG0002008	1	0	1	1	3
OG0002009	1	0	1	1	3
OG0002010	1	0	1	1	3
OG0002011	1	0	1	1	3
OG0002012	0	1	1	1	3
OG0002013	0	1	1	1	3
OG0002014	0	1	1	1	3
OG0002015	0	1	1	1	3
OG0002016	0	1	1	1	3
OG0002017	0	1	1	1	3
OG0002018	0	1	1	1	3
OG0002019	0	1	0	2	3
OG0002020	0	1	1	1	3
OG0002021	0	1	1	1	3
OG0002022	0	1	1	1	3
OG0002023	0	1	1	1	3
OG0002024	0	1	1	1	3
OG0002025	0	1	1	1	3
OG0002026	0	1	1	1	3
OG0002027	0	1	1	1	3
OG0002028	0	1	1	1	3
OG0002029	0	1	1	1	3
OG0002030	0	1	1	1	3
OG0002031	0	1	1	1	3
OG0002032	0	1	1	1	3
OG0002033	0	1	0	2	3
OG0002034	0	1	1	1	3
OG0002035	0	1	1	1	3
OG0002036	0	1	1	1	3
OG0002037	0	1	1	1	3
OG0002038	0	1	0	2	3
OG0002039	0	1	1	1	3
OG0002040	0	1	0	2	3
OG0002041	0	1	1	1	3
OG0002042	0	1	2	0	3
OG0002043	0	1	1	1	3
OG0002044	0	1	1	1	3
OG0002045	0	1	1	1	3
OG0002046	0	1	2	0	3
OG0002047	0	2	1	0	3
OG0002048	0	1	0	2	3
OG0002049	0	1	1	1	3
OG0002050	0	1	1	1	3
OG0002051	0	1	1	1	3
OG0002052	0	1	1	1	3
OG0002053	0	1	0	2	3
OG0002054	0	1	1	1	3
OG0002055	0	1	1	1	3
OG0002056	0	1	1	1	3
OG0002057	0	1	1	1	3
OG0002058	0	1	1	1	3
OG0002059	0	1	1	1	3
OG0002060	0	1	1	1	3
OG0002061	0	1	1	1	3
OG0002062	0	1	1	1	3
OG0002063	0	1	1	1	3
OG0002064	0	1	1	1	3
OG0002065	0	1	1	1	3
OG0002066	0	1	1	1	3
OG0002067	0	1	1	1	3
OG0002068	0	1	1	1	3
OG0002069	0	2	1	0	3
OG0002070	0	1	1	1	3
OG0002071	0	1	1	1	3
OG0002072	0	1	1	1	3
OG0002073	0	1	1	1	3
OG0002074	0	1	1	1	3
OG0002075	0	1	1	1	3
OG0002076	0	1	2	0	3
OG0002077	0	1	1	1	3
OG0002078	0	1	1	1	3
OG0002079	0	1	1	1	3
OG0002080	0	2	0	1	3
OG0002081	0	1	1	1	3
OG0002082	0	1	1	1	3
OG0002083	0	1	1	1	3
OG0002084	0	1	1	1	3
OG0002085	0	1	1	1	3
OG0002086	0	1	1	1	3
OG0002087	0	2	1	0	3
OG0002088	0	1	0	2	3
OG0002089	0	1	1	1	3
OG0002090	0	1	2	0	3
OG0002091	0	1	1	1	3
OG0002092	0	1	1	1	3
OG0002093	0	1	1	1	3
OG0002094	0	1	1	1	3
OG0002095	0	1	1	1	3
OG0002096	0	1	1	1	3
OG0002097	0	1	1	1	3
OG0002098	0	1	0	2	3
OG0002099	0	1	1	1	3
OG0002100	0	1	1	1	3
OG0002101	0	1	1	1	3
OG0002102	0	1	1	1	3
OG0002103	0	1	1	1	3
OG0002104	0	1	1	1	3
OG0002105	0	1	1	1	3
OG0002106	0	1	1	1	3
OG0002107	0	1	1	1	3
OG0002108	0	1	1	1	3
OG0002109	0	1	1	1	3
OG0002110	0	1	1	1	3
OG0002111	0	1	1	1	3
OG0002112	0	1	1	1	3
OG0002113	0	1	1	1	3
OG0002114	0	1	1	1	3
OG0002115	0	1	1	1	3
OG0002116	0	1	1	1	3
OG0002117	0	2	0	1	3
OG0002118	0	1	1	1	3
OG0002119	0	1	1	1	3
OG0002120	0	1	1	1	3
OG0002121	0	1	1	1	3
OG0002122	0	1	0	2	3
OG0002123	0	1	1	1	3
OG0002124	0	1	1	1	3
OG0002125	0	1	2	0	3
OG0002126	0	1	1	1	3
OG0002127	0	1	1	1	3
OG0002128	0	1	1	1	3
OG0002129	0	1	1	1	3
OG0002130	0	1	1	1	3
OG0002131	0	1	1	1	3
OG0002132	0	1	1	1	3
OG0002133	0	1	1	1	3
OG0002134	0	1	1	1	3
OG0002135	0	1	1	1	3
OG0002136	0	1	1	1	3
OG0002137	0	1	1	1	3
OG0002138	0	1	1	1	3
OG0002139	0	1	1	1	3
OG0002140	0	1	1	1	3
OG0002141	0	1	1	1	3
OG0002142	0	1	1	1	3
OG0002143	0	1	1	1	3
OG0002144	0	1	1	1	3
OG0002145	0	1	1	1	3
OG0002146	0	1	1	1	3
OG0002147	0	1	1	1	3
OG0002148	0	1	1	1	3
OG0002149	0	1	0	2	3
OG0002150	0	1	1	1	3
OG0002151	0	1	1	1	3
OG0002152	0	1	1	1	3
OG0002153	0	1	1	1	3
OG0002154	0	1	1	1	3
OG0002155	0	1	1	1	3
OG0002156	0	1	1	1	3
OG0002157	0	1	2	0	3
OG0002158	0	2	0	1	3
OG0002159	0	1	1	1	3
OG0002160	0	1	1	1	3
OG0002161	0	1	1	1	3
OG0002162	0	1	1	1	3
OG0002163	0	1	1	1	3
OG0002164	0	1	1	1	3
OG0002165	0	1	1	1	3
OG0002166	0	1	1	1	3
OG0002167	0	1	1	1	3
OG0002168	0	1	1	1	3
OG0002169	0	1	2	0	3
OG0002170	0	1	1	1	3
OG0002171	0	1	1	1	3
OG0002172	0	1	1	1	3
OG0002173	0	1	1	1	3
OG0002174	0	1	1	1	3
OG0002175	0	1	1	1	3
OG0002176	0	1	1	1	3
OG0002177	0	1	1	1	3
OG0002178	0	1	1	1	3
OG0002179	0	1	1	1	3
OG0002180	0	1	1	1	3
OG0002181	0	1	1	1	3
OG0002182	0	1	1	1	3
OG0002183	0	1	1	1	3
OG0002184	0	1	1	1	3
OG0002185	0	1	1	1	3
OG0002186	0	1	1	1	3
OG0002187	0	1	1	1	3
OG0002188	0	1	1	1	3
OG0002189	0	1	1	1	3
OG0002190	0	1	1	1	3
OG0002191	0	1	1	1	3
OG0002192	0	1	1	1	3
OG0002193	0	1	1	1	3
OG0002194	0	1	1	1	3
OG0002195	0	1	1	1	3
OG0002196	0	1	1	1	3
OG0002197	0	1	1	1	3
OG0002198	0	1	1	1	3
OG0002199	0	1	1	1	3
OG0002200	0	1	1	1	3
OG0002201	0	1	1	1	3
OG0002202	0	1	1	1	3
OG0002203	0	1	1	1	3
OG0002204	0	1	1	1	3
OG0002205	0	1	1	1	3
OG0002206	0	1	1	1	3
OG0002207	0	1	1	1	3
OG0002208	0	1	1	1	3
OG0002209	0	1	1	1	3
OG0002210	0	1	1	1	3
OG0002211	0	1	0	2	3
OG0002212	0	1	1	1	3
OG0002213	0	1	1	1	3
OG0002214	0	1	1	1	3
OG0002215	0	1	0	2	3
OG0002216	0	1	1	1	3
OG0002217	0	1	1	1	3
OG0002218	0	1	1	1	3
OG0002219	0	1	1	1	3
OG0002220	0	1	1	1	3
OG0002221	0	1	1	1	3
OG0002222	0	1	1	1	3
OG0002223	0	1	1	1	3
OG0002224	0	1	1	1	3
OG0002225	0	1	0	2	3
OG0002226	0	1	1	1	3
OG0002227	0	1	1	1	3
OG0002228	0	1	1	1	3
OG0002229	0	1	1	1	3
OG0002230	0	1	1	1	3
OG0002231	0	1	1	1	3
OG0002232	0	1	1	1	3
OG0002233	0	1	1	1	3
OG0002234	0	1	1	1	3
OG0002235	0	1	1	1	3
OG0002236	0	1	1	1	3
OG0002237	0	1	1	1	3
OG0002238	0	1	1	1	3
OG0002239	0	2	1	0	3
OG0002240	0	1	1	1	3
OG0002241	0	1	1	1	3
OG0002242	0	1	1	1	3
OG0002243	0	1	1	1	3
OG0002244	0	1	1	1	3
OG0002245	0	1	1	1	3
OG0002246	0	1	1	1	3
OG0002247	0	1	1	1	3
OG0002248	0	1	1	1	3
OG0002249	0	1	1	1	3
OG0002250	0	1	1	1	3
OG0002251	0	1	1	1	3
OG0002252	0	1	1	1	3
OG0002253	0	1	1	1	3
OG0002254	0	1	1	1	3
OG0002255	0	1	1	1	3
OG0002256	0	1	1	1	3
OG0002257	0	1	1	1	3
OG0002258	0	1	1	1	3
OG0002259	0	1	1	1	3
OG0002260	0	1	1	1	3
OG0002261	0	1	1	1	3
OG0002262	0	1	1	1	3
OG0002263	0	1	1	1	3
OG0002264	0	1	0	2	3
OG0002265	0	1	1	1	3
OG0002266	0	1	1	1	3
OG0002267	0	1	1	1	3
OG0002268	0	1	1	1	3
OG0002269	0	1	1	1	3
OG0002270	0	1	1	1	3
OG0002271	0	1	1	1	3
OG0002272	0	1	1	1	3
OG0002273	0	1	1	1	3
OG0002274	0	1	1	1	3
OG0002275	0	1	1	1	3
OG0002276	0	1	1	1	3
OG0002277	0	1	1	1	3
OG0002278	0	1	0	2	3
OG0002279	0	1	1	1	3
OG0002280	0	1	1	1	3
OG0002281	0	1	1	1	3
OG0002282	0	1	1	1	3
OG0002283	0	1	1	1	3
OG0002284	0	1	1	1	3
OG0002285	0	1	1	1	3
OG0002286	0	1	1	1	3
OG0002287	0	1	1	1	3
OG0002288	0	1	1	1	3
OG0002289	0	2	1	0	3
OG0002290	0	1	1	1	3
OG0002291	0	1	1	1	3
OG0002292	0	0	1	2	3
OG0002293	0	0	3	0	3
OG0002294	0	0	1	2	3
OG0002295	0	0	2	1	3
OG0002296	0	0	3	0	3
OG0002297	0	0	3	0	3
OG0002298	0	0	3	0	3
OG0002299	0	0	1	2	3
OG0002300	0	0	1	2	3
OG0002301	0	0	3	0	3
OG0002302	0	0	1	2	3
OG0002303	0	0	2	1	3
OG0002304	0	0	1	2	3
OG0002305	0	0	3	0	3
OG0002306	0	0	3	0	3
OG0002307	0	0	1	2	3
OG0002308	0	0	2	1	3
OG0002309	0	0	3	0	3
OG0002310	0	0	3	0	3
OG0002311	0	0	1	2	3
OG0002312	0	0	2	1	3
OG0002313	0	0	2	1	3
OG0002314	0	0	3	0	3
OG0002315	0	0	1	2	3
OG0002316	0	0	2	1	3
OG0002317	0	0	2	1	3
OG0002318	0	0	3	0	3
OG0002319	0	0	2	1	3
OG0002320	0	0	2	1	3
OG0002321	0	0	3	0	3
OG0002322	0	0	2	1	3
OG0002323	0	0	2	1	3
OG0002324	0	0	3	0	3
OG0002325	0	0	1	2	3
OG0002326	0	0	3	0	3
OG0002327	0	0	1	2	3
OG0002328	0	0	2	1	3
OG0002329	0	0	3	0	3
OG0002330	0	0	3	0	3
OG0002331	0	0	2	1	3
OG0002332	0	0	1	2	3
OG0002333	0	0	2	1	3
OG0002334	0	0	3	0	3
OG0002335	0	0	3	0	3
OG0002336	0	0	3	0	3
OG0002337	0	0	3	0	3
OG0002338	0	0	1	2	3
OG0002339	0	0	1	2	3
OG0002340	0	0	2	1	3
OG0002341	0	0	3	0	3
OG0002342	0	0	3	0	3
OG0002343	0	0	1	2	3
OG0002344	0	0	3	0	3
OG0002345	0	0	3	0	3
OG0002346	0	0	3	0	3
OG0002347	0	0	3	0	3
OG0002348	0	0	3	0	3
OG0002349	0	0	3	0	3
OG0002350	0	0	2	1	3
OG0002351	0	0	1	2	3
OG0002352	0	0	3	0	3
OG0002353	0	0	3	0	3
OG0002354	0	0	2	1	3
OG0002355	0	0	3	0	3
OG0002356	0	0	2	1	3
OG0002357	0	0	3	0	3
OG0002358	0	0	2	1	3
OG0002359	0	0	3	0	3
OG0002360	0	0	2	1	3
OG0002361	0	0	3	0	3
OG0002362	0	0	3	0	3
OG0002363	0	0	3	0	3
OG0002364	0	0	2	1	3
OG0002365	0	0	1	2	3
OG0002366	0	0	1	2	3
OG0002367	0	0	1	2	3
OG0002368	0	0	1	2	3
OG0002369	0	0	1	2	3
OG0002370	0	0	2	1	3
OG0002371	0	0	2	1	3
OG0002372	0	0	1	2	3
OG0002373	0	0	2	1	3
OG0002374	0	0	2	1	3
OG0002375	0	0	2	1	3
OG0002376	0	0	1	2	3
OG0002377	0	0	2	1	3
OG0002378	0	0	2	1	3
OG0002379	0	0	3	0	3
OG0002380	0	0	2	1	3
OG0002381	0	0	2	1	3
OG0002382	0	0	3	0	3
OG0002383	0	0	2	1	3
OG0002384	0	0	1	2	3
OG0002385	0	0	1	2	3
OG0002386	0	0	2	1	3
OG0002387	0	0	2	1	3
OG0002388	0	0	2	1	3
OG0002389	0	0	2	1	3
OG0002390	0	0	1	2	3
OG0002391	0	0	3	0	3
OG0002392	0	0	1	2	3
OG0002393	0	0	1	2	3
OG0002394	0	0	1	2	3
OG0002395	0	0	2	1	3
OG0002396	0	0	2	1	3
OG0002397	0	0	2	1	3
OG0002398	0	0	1	2	3
OG0002399	0	0	1	2	3
OG0002400	0	0	2	1	3
OG0002401	0	0	2	1	3
OG0002402	0	0	2	1	3
OG0002403	0	0	1	2	3
OG0002404	0	0	2	1	3
OG0002405	0	0	2	1	3
OG0002406	0	0	1	2	3
OG0002407	0	0	1	2	3
OG0002408	0	0	2	1	3
OG0002409	0	0	3	0	3
OG0002410	0	0	1	2	3
OG0002411	0	0	2	1	3
OG0002412	0	0	1	2	3
OG0002413	0	0	1	2	3
OG0002414	0	0	2	1	3
OG0002415	0	0	3	0	3
OG0002416	0	0	1	2	3
OG0002417	0	0	3	0	3
OG0002418	0	0	2	1	3
OG0002419	0	0	3	0	3
OG0002420	0	0	3	0	3
OG0002421	0	0	3	0	3
OG0002422	0	0	1	2	3
OG0002423	0	0	1	2	3
OG0002424	0	0	2	1	3
OG0002425	0	0	2	1	3
OG0002426	0	0	3	0	3
OG0002427	0	0	1	2	3
OG0002428	0	0	2	1	3
OG0002429	0	0	3	0	3
OG0002430	0	0	1	2	3
OG0002431	0	0	2	1	3
OG0002432	0	0	3	0	3
OG0002433	0	0	2	1	3
OG0002434	0	0	2	1	3
OG0002435	0	0	3	0	3
OG0002436	0	0	1	2	3
OG0002437	0	0	3	0	3
OG0002438	0	0	1	2	3
OG0002439	0	0	1	2	3
OG0002440	0	0	1	2	3
OG0002441	0	0	3	0	3
OG0002442	0	0	2	1	3
OG0002443	0	0	3	0	3
OG0002444	0	0	3	0	3
OG0002445	0	0	3	0	3
OG0002446	0	0	3	0	3
OG0002447	0	0	3	0	3
OG0002448	0	0	1	2	3
OG0002449	0	0	2	1	3
OG0002450	0	0	1	2	3
OG0002451	0	0	2	1	3
OG0002452	0	0	1	2	3
OG0002453	0	0	1	2	3
OG0002454	0	0	3	0	3
OG0002455	0	0	1	2	3
OG0002456	0	0	2	1	3
OG0002457	0	0	0	3	3
OG0002458	0	0	0	3	3
OG0002459	0	0	0	3	3
OG0002460	0	0	0	3	3
OG0002461	0	0	0	3	3
OG0002462	0	0	0	3	3
OG0002463	0	0	0	3	3
OG0002464	0	0	0	3	3
OG0002465	0	0	0	3	3
OG0002466	0	0	0	3	3
OG0002467	0	0	0	3	3
OG0002468	0	0	0	3	3
OG0002469	0	0	0	3	3
OG0002470	0	0	0	3	3
OG0002471	0	0	0	3	3
OG0002472	0	0	0	3	3
OG0002473	0	0	0	3	3
OG0002474	0	0	0	3	3
OG0002475	0	0	0	3	3
OG0002476	0	0	0	3	3
OG0002477	0	0	0	3	3
OG0002478	0	0	0	3	3
OG0002479	0	0	0	3	3
OG0002480	0	0	0	3	3
OG0002481	0	0	0	3	3
OG0002482	0	0	0	3	3
OG0002483	0	0	0	3	3
OG0002484	0	0	0	3	3
OG0002485	0	0	0	3	3
OG0002486	0	0	0	3	3
OG0002487	0	0	0	3	3
OG0002488	0	0	0	3	3
OG0002489	0	0	0	3	3
OG0002490	0	0	0	3	3
OG0002491	0	0	0	3	3
OG0002492	0	0	0	3	3
OG0002493	0	0	0	3	3
OG0002494	0	0	0	3	3
OG0002495	0	0	0	3	3
OG0002496	0	0	0	3	3
OG0002497	0	0	0	3	3
OG0002498	0	0	0	3	3
OG0002499	0	0	0	3	3
OG0002500	0	0	0	3	3
OG0002501	0	0	0	3	3
OG0002502	0	0	0	3	3
OG0002503	0	0	0	3	3
OG0002504	0	0	0	3	3
OG0002505	0	0	0	3	3
OG0002506	0	0	0	3	3
OG0002507	0	0	0	3	3
OG0002508	0	0	0	3	3
OG0002509	0	0	0	3	3
OG0002510	0	0	0	3	3
OG0002511	0	0	0	3	3
OG0002512	0	0	0	3	3
OG0002513	0	0	0	3	3
OG0002514	0	0	0	3	3
OG0002515	0	0	0	3	3
OG0002516	0	0	0	3	3
OG0002517	0	0	0	3	3
OG0002518	0	0	0	3	3
OG0002519	0	0	0	3	3
OG0002520	0	0	0	3	3
OG0002521	0	0	0	3	3
OG0002522	0	0	0	3	3
OG0002523	0	0	0	3	3
OG0002524	0	0	0	3	3
OG0002525	0	0	0	3	3
OG0002526	0	0	0	3	3
OG0002527	0	0	0	3	3
OG0002528	0	0	0	3	3
OG0002529	0	0	0	3	3
OG0002530	0	0	0	3	3
OG0002531	0	0	0	3	3
OG0002532	0	0	0	3	3
OG0002533	0	0	0	3	3
OG0002534	0	0	0	3	3
OG0002535	0	0	0	3	3
OG0002536	0	0	0	3	3
OG0002537	1	0	0	1	2
OG0002538	1	1	0	0	2
OG0002539	1	1	0	0	2
OG0002540	1	0	0	1	2
OG0002541	2	0	0	0	2
OG0002542	2	0	0	0	2
OG0002543	2	0	0	0	2
OG0002544	2	0	0	0	2
OG0002545	1	0	0	1	2
OG0002546	1	0	1	0	2
OG0002547	1	0	0	1	2
OG0002548	1	0	0	1	2
OG0002549	2	0	0	0	2
OG0002550	1	1	0	0	2
OG0002551	2	0	0	0	2
OG0002552	2	0	0	0	2
OG0002553	2	0	0	0	2
OG0002554	2	0	0	0	2
OG0002555	1	0	0	1	2
OG0002556	1	0	0	1	2
OG0002557	2	0	0	0	2
OG0002558	1	0	1	0	2
OG0002559	2	0	0	0	2
OG0002560	1	0	0	1	2
OG0002561	1	0	0	1	2
OG0002562	1	0	0	1	2
OG0002563	1	0	0	1	2
OG0002564	1	0	0	1	2
OG0002565	1	0	0	1	2
OG0002566	1	0	1	0	2
OG0002567	1	0	0	1	2
OG0002568	1	0	0	1	2
OG0002569	1	0	0	1	2
OG0002570	1	0	0	1	2
OG0002571	2	0	0	0	2
OG0002572	1	0	0	1	2
OG0002573	1	0	0	1	2
OG0002574	2	0	0	0	2
OG0002575	1	0	0	1	2
OG0002576	1	0	0	1	2
OG0002577	1	0	0	1	2
OG0002578	1	0	0	1	2
OG0002579	1	0	0	1	2
OG0002580	1	0	1	0	2
OG0002581	1	0	0	1	2
OG0002582	2	0	0	0	2
OG0002583	1	0	0	1	2
OG0002584	1	0	1	0	2
OG0002585	2	0	0	0	2
OG0002586	2	0	0	0	2
OG0002587	2	0	0	0	2
OG0002588	2	0	0	0	2
OG0002589	2	0	0	0	2
OG0002590	2	0	0	0	2
OG0002591	1	0	0	1	2
OG0002592	2	0	0	0	2
OG0002593	1	0	1	0	2
OG0002594	1	0	0	1	2
OG0002595	1	0	0	1	2
OG0002596	2	0	0	0	2
OG0002597	2	0	0	0	2
OG0002598	1	0	0	1	2
OG0002599	2	0	0	0	2
OG0002600	1	0	1	0	2
OG0002601	2	0	0	0	2
OG0002602	1	0	0	1	2
OG0002603	1	0	0	1	2
OG0002604	1	0	1	0	2
OG0002605	1	0	0	1	2
OG0002606	1	0	0	1	2
OG0002607	1	0	0	1	2
OG0002608	1	0	0	1	2
OG0002609	2	0	0	0	2
OG0002610	1	0	0	1	2
OG0002611	1	0	1	0	2
OG0002612	1	0	0	1	2
OG0002613	1	0	1	0	2
OG0002614	1	0	1	0	2
OG0002615	1	0	1	0	2
OG0002616	1	0	0	1	2
OG0002617	2	0	0	0	2
OG0002618	1	0	0	1	2
OG0002619	1	1	0	0	2
OG0002620	2	0	0	0	2
OG0002621	1	0	0	1	2
OG0002622	1	0	0	1	2
OG0002623	1	0	0	1	2
OG0002624	1	0	1	0	2
OG0002625	2	0	0	0	2
OG0002626	1	0	0	1	2
OG0002627	1	0	0	1	2
OG0002628	1	0	0	1	2
OG0002629	1	0	0	1	2
OG0002630	1	0	0	1	2
OG0002631	1	0	0	1	2
OG0002632	1	0	0	1	2
OG0002633	1	0	1	0	2
OG0002634	1	0	0	1	2
OG0002635	2	0	0	0	2
OG0002636	1	0	1	0	2
OG0002637	2	0	0	0	2
OG0002638	1	0	0	1	2
OG0002639	1	0	0	1	2
OG0002640	2	0	0	0	2
OG0002641	1	0	0	1	2
OG0002642	1	0	0	1	2
OG0002643	1	0	0	1	2
OG0002644	1	0	1	0	2
OG0002645	1	0	0	1	2
OG0002646	1	0	0	1	2
OG0002647	1	0	0	1	2
OG0002648	1	0	0	1	2
OG0002649	1	0	0	1	2
OG0002650	1	0	0	1	2
OG0002651	1	0	0	1	2
OG0002652	1	0	0	1	2
OG0002653	2	0	0	0	2
OG0002654	1	1	0	0	2
OG0002655	1	0	1	0	2
OG0002656	2	0	0	0	2
OG0002657	1	0	1	0	2
OG0002658	1	0	0	1	2
OG0002659	1	0	0	1	2
OG0002660	2	0	0	0	2
OG0002661	2	0	0	0	2
OG0002662	1	0	1	0	2
OG0002663	1	0	0	1	2
OG0002664	1	0	0	1	2
OG0002665	1	0	0	1	2
OG0002666	2	0	0	0	2
OG0002667	1	0	0	1	2
OG0002668	1	0	1	0	2
OG0002669	2	0	0	0	2
OG0002670	1	0	0	1	2
OG0002671	1	0	0	1	2
OG0002672	2	0	0	0	2
OG0002673	2	0	0	0	2
OG0002674	1	0	0	1	2
OG0002675	1	0	0	1	2
OG0002676	1	0	0	1	2
OG0002677	1	0	0	1	2
OG0002678	1	0	0	1	2
OG0002679	1	0	1	0	2
OG0002680	1	0	0	1	2
OG0002681	2	0	0	0	2
OG0002682	1	0	0	1	2
OG0002683	2	0	0	0	2
OG0002684	1	0	0	1	2
OG0002685	2	0	0	0	2
OG0002686	2	0	0	0	2
OG0002687	2	0	0	0	2
OG0002688	1	0	1	0	2
OG0002689	2	0	0	0	2
OG0002690	1	0	0	1	2
OG0002691	1	0	0	1	2
OG0002692	1	0	0	1	2
OG0002693	1	0	0	1	2
OG0002694	2	0	0	0	2
OG0002695	2	0	0	0	2
OG0002696	1	0	1	0	2
OG0002697	1	0	0	1	2
OG0002698	1	1	0	0	2
OG0002699	1	0	0	1	2
OG0002700	1	0	0	1	2
OG0002701	1	0	0	1	2
OG0002702	1	0	0	1	2
OG0002703	2	0	0	0	2
OG0002704	1	0	1	0	2
OG0002705	1	0	0	1	2
OG0002706	1	0	0	1	2
OG0002707	1	0	0	1	2
OG0002708	1	0	1	0	2
OG0002709	1	0	0	1	2
OG0002710	1	0	0	1	2
OG0002711	2	0	0	0	2
OG0002712	1	0	0	1	2
OG0002713	1	0	0	1	2
OG0002714	1	0	0	1	2
OG0002715	1	0	0	1	2
OG0002716	1	0	0	1	2
OG0002717	2	0	0	0	2
OG0002718	2	0	0	0	2
OG0002719	2	0	0	0	2
OG0002720	2	0	0	0	2
OG0002721	2	0	0	0	2
OG0002722	1	0	0	1	2
OG0002723	1	0	1	0	2
OG0002724	1	0	0	1	2
OG0002725	1	0	0	1	2
OG0002726	2	0	0	0	2
OG0002727	1	0	0	1	2
OG0002728	2	0	0	0	2
OG0002729	1	0	0	1	2
OG0002730	1	0	0	1	2
OG0002731	1	0	0	1	2
OG0002732	1	0	0	1	2
OG0002733	1	0	0	1	2
OG0002734	2	0	0	0	2
OG0002735	1	0	0	1	2
OG0002736	1	0	0	1	2
OG0002737	2	0	0	0	2
OG0002738	2	0	0	0	2
OG0002739	1	0	0	1	2
OG0002740	1	0	0	1	2
OG0002741	1	0	0	1	2
OG0002742	1	1	0	0	2
OG0002743	1	0	0	1	2
OG0002744	1	0	0	1	2
OG0002745	1	0	0	1	2
OG0002746	1	0	0	1	2
OG0002747	1	0	0	1	2
OG0002748	1	0	0	1	2
OG0002749	2	0	0	0	2
OG0002750	1	0	0	1	2
OG0002751	1	0	0	1	2
OG0002752	1	0	0	1	2
OG0002753	1	0	1	0	2
OG0002754	1	0	1	0	2
OG0002755	1	0	0	1	2
OG0002756	1	0	0	1	2
OG0002757	1	0	0	1	2
OG0002758	1	0	0	1	2
OG0002759	1	0	0	1	2
OG0002760	1	0	1	0	2
OG0002761	2	0	0	0	2
OG0002762	1	0	0	1	2
OG0002763	1	0	0	1	2
OG0002764	1	0	0	1	2
OG0002765	1	0	0	1	2
OG0002766	1	0	0	1	2
OG0002767	1	0	0	1	2
OG0002768	1	0	0	1	2
OG0002769	1	0	0	1	2
OG0002770	1	0	0	1	2
OG0002771	1	0	0	1	2
OG0002772	1	0	0	1	2
OG0002773	2	0	0	0	2
OG0002774	1	0	0	1	2
OG0002775	1	0	0	1	2
OG0002776	1	0	0	1	2
OG0002777	2	0	0	0	2
OG0002778	2	0	0	0	2
OG0002779	1	0	0	1	2
OG0002780	2	0	0	0	2
OG0002781	1	0	0	1	2
OG0002782	2	0	0	0	2
OG0002783	1	0	0	1	2
OG0002784	1	0	0	1	2
OG0002785	1	0	1	0	2
OG0002786	2	0	0	0	2
OG0002787	1	0	0	1	2
OG0002788	1	0	1	0	2
OG0002789	2	0	0	0	2
OG0002790	1	0	0	1	2
OG0002791	1	0	0	1	2
OG0002792	1	0	0	1	2
OG0002793	2	0	0	0	2
OG0002794	1	0	0	1	2
OG0002795	1	0	0	1	2
OG0002796	1	0	1	0	2
OG0002797	1	0	0	1	2
OG0002798	2	0	0	0	2
OG0002799	1	0	0	1	2
OG0002800	1	0	0	1	2
OG0002801	1	0	0	1	2
OG0002802	1	0	1	0	2
OG0002803	1	0	0	1	2
OG0002804	1	1	0	0	2
OG0002805	1	1	0	0	2
OG0002806	1	0	0	1	2
OG0002807	2	0	0	0	2
OG0002808	2	0	0	0	2
OG0002809	1	0	0	1	2
OG0002810	1	0	0	1	2
OG0002811	1	0	0	1	2
OG0002812	1	0	0	1	2
OG0002813	1	0	0	1	2
OG0002814	2	0	0	0	2
OG0002815	2	0	0	0	2
OG0002816	1	0	0	1	2
OG0002817	1	0	0	1	2
OG0002818	1	0	0	1	2
OG0002819	1	0	0	1	2
OG0002820	2	0	0	0	2
OG0002821	1	1	0	0	2
OG0002822	1	0	0	1	2
OG0002823	1	0	1	0	2
OG0002824	1	0	0	1	2
OG0002825	1	0	0	1	2
OG0002826	1	0	0	1	2
OG0002827	2	0	0	0	2
OG0002828	1	0	0	1	2
OG0002829	1	0	0	1	2
OG0002830	1	0	0	1	2
OG0002831	1	0	0	1	2
OG0002832	1	0	0	1	2
OG0002833	1	0	0	1	2
OG0002834	1	0	0	1	2
OG0002835	1	0	0	1	2
OG0002836	1	0	0	1	2
OG0002837	1	0	0	1	2
OG0002838	1	0	0	1	2
OG0002839	1	0	1	0	2
OG0002840	2	0	0	0	2
OG0002841	1	0	0	1	2
OG0002842	1	0	0	1	2
OG0002843	1	0	1	0	2
OG0002844	1	0	0	1	2
OG0002845	1	0	0	1	2
OG0002846	1	0	0	1	2
OG0002847	1	1	0	0	2
OG0002848	1	0	0	1	2
OG0002849	1	0	0	1	2
OG0002850	1	0	0	1	2
OG0002851	1	0	0	1	2
OG0002852	1	0	0	1	2
OG0002853	2	0	0	0	2
OG0002854	1	0	0	1	2
OG0002855	1	0	0	1	2
OG0002856	1	0	0	1	2
OG0002857	1	0	0	1	2
OG0002858	1	0	0	1	2
OG0002859	1	0	0	1	2
OG0002860	2	0	0	0	2
OG0002861	1	0	0	1	2
OG0002862	1	0	0	1	2
OG0002863	1	0	0	1	2
OG0002864	1	0	0	1	2
OG0002865	1	0	0	1	2
OG0002866	1	0	0	1	2
OG0002867	1	0	1	0	2
OG0002868	2	0	0	0	2
OG0002869	1	0	0	1	2
OG0002870	1	0	0	1	2
OG0002871	1	0	0	1	2
OG0002872	1	0	0	1	2
OG0002873	2	0	0	0	2
OG0002874	2	0	0	0	2
OG0002875	1	0	0	1	2
OG0002876	1	0	0	1	2
OG0002877	1	0	0	1	2
OG0002878	1	0	0	1	2
OG0002879	1	0	0	1	2
OG0002880	1	0	1	0	2
OG0002881	1	0	0	1	2
OG0002882	1	0	0	1	2
OG0002883	1	0	0	1	2
OG0002884	2	0	0	0	2
OG0002885	1	0	0	1	2
OG0002886	1	0	0	1	2
OG0002887	2	0	0	0	2
OG0002888	1	0	1	0	2
OG0002889	1	1	0	0	2
OG0002890	1	0	0	1	2
OG0002891	1	0	0	1	2
OG0002892	1	0	0	1	2
OG0002893	1	0	0	1	2
OG0002894	1	0	0	1	2
OG0002895	1	0	0	1	2
OG0002896	1	0	1	0	2
OG0002897	1	0	0	1	2
OG0002898	1	0	0	1	2
OG0002899	1	0	0	1	2
OG0002900	1	0	0	1	2
OG0002901	1	0	0	1	2
OG0002902	1	0	0	1	2
OG0002903	1	0	1	0	2
OG0002904	1	0	1	0	2
OG0002905	1	0	0	1	2
OG0002906	1	0	0	1	2
OG0002907	1	0	0	1	2
OG0002908	2	0	0	0	2
OG0002909	1	0	0	1	2
OG0002910	1	0	0	1	2
OG0002911	1	0	0	1	2
OG0002912	2	0	0	0	2
OG0002913	1	0	0	1	2
OG0002914	1	0	0	1	2
OG0002915	1	0	0	1	2
OG0002916	1	0	0	1	2
OG0002917	1	1	0	0	2
OG0002918	2	0	0	0	2
OG0002919	1	0	0	1	2
OG0002920	2	0	0	0	2
OG0002921	1	0	0	1	2
OG0002922	1	0	0	1	2
OG0002923	1	0	0	1	2
OG0002924	1	0	0	1	2
OG0002925	1	0	0	1	2
OG0002926	2	0	0	0	2
OG0002927	2	0	0	0	2
OG0002928	2	0	0	0	2
OG0002929	1	0	0	1	2
OG0002930	1	0	1	0	2
OG0002931	1	0	0	1	2
OG0002932	1	0	0	1	2
OG0002933	2	0	0	0	2
OG0002934	1	0	1	0	2
OG0002935	2	0	0	0	2
OG0002936	1	0	0	1	2
OG0002937	1	0	0	1	2
OG0002938	1	0	1	0	2
OG0002939	1	0	0	1	2
OG0002940	1	0	1	0	2
OG0002941	1	0	0	1	2
OG0002942	1	0	1	0	2
OG0002943	1	0	1	0	2
OG0002944	1	0	1	0	2
OG0002945	1	1	0	0	2
OG0002946	1	0	1	0	2
OG0002947	1	0	0	1	2
OG0002948	2	0	0	0	2
OG0002949	2	0	0	0	2
OG0002950	1	0	0	1	2
OG0002951	2	0	0	0	2
OG0002952	1	1	0	0	2
OG0002953	1	0	0	1	2
OG0002954	1	0	0	1	2
OG0002955	1	1	0	0	2
OG0002956	2	0	0	0	2
OG0002957	1	0	0	1	2
OG0002958	1	0	0	1	2
OG0002959	1	1	0	0	2
OG0002960	1	0	0	1	2
OG0002961	1	0	0	1	2
OG0002962	1	1	0	0	2
OG0002963	1	0	0	1	2
OG0002964	2	0	0	0	2
OG0002965	1	0	1	0	2
OG0002966	2	0	0	0	2
OG0002967	2	0	0	0	2
OG0002968	2	0	0	0	2
OG0002969	2	0	0	0	2
OG0002970	1	0	0	1	2
OG0002971	1	0	0	1	2
OG0002972	1	0	0	1	2
OG0002973	2	0	0	0	2
OG0002974	2	0	0	0	2
OG0002975	1	0	0	1	2
OG0002976	1	0	0	1	2
OG0002977	0	1	0	1	2
OG0002978	0	1	0	1	2
OG0002979	0	1	0	1	2
OG0002980	0	1	1	0	2
OG0002981	0	1	0	1	2
OG0002982	0	1	0	1	2
OG0002983	0	1	1	0	2
OG0002984	0	1	0	1	2
OG0002985	0	1	0	1	2
OG0002986	0	1	0	1	2
OG0002987	0	1	1	0	2
OG0002988	0	1	0	1	2
OG0002989	0	1	0	1	2
OG0002990	0	2	0	0	2
OG0002991	0	1	0	1	2
OG0002992	0	1	0	1	2
OG0002993	0	1	0	1	2
OG0002994	0	1	0	1	2
OG0002995	0	1	0	1	2
OG0002996	0	1	0	1	2
OG0002997	0	1	0	1	2
OG0002998	0	1	0	1	2
OG0002999	0	1	1	0	2
OG0003000	0	1	1	0	2
OG0003001	0	1	0	1	2
OG0003002	0	1	1	0	2
OG0003003	0	1	1	0	2
OG0003004	0	1	0	1	2
OG0003005	0	1	0	1	2
OG0003006	0	1	0	1	2
OG0003007	0	1	0	1	2
OG0003008	0	1	0	1	2
OG0003009	0	1	0	1	2
OG0003010	0	1	0	1	2
OG0003011	0	1	0	1	2
OG0003012	0	1	0	1	2
OG0003013	0	1	0	1	2
OG0003014	0	1	0	1	2
OG0003015	0	1	0	1	2
OG0003016	0	1	0	1	2
OG0003017	0	1	0	1	2
OG0003018	0	1	0	1	2
OG0003019	0	1	1	0	2
OG0003020	0	1	0	1	2
OG0003021	0	1	1	0	2
OG0003022	0	1	0	1	2
OG0003023	0	1	0	1	2
OG0003024	0	1	0	1	2
OG0003025	0	1	0	1	2
OG0003026	0	1	0	1	2
OG0003027	0	1	0	1	2
OG0003028	0	1	0	1	2
OG0003029	0	1	1	0	2
OG0003030	0	2	0	0	2
OG0003031	0	2	0	0	2
OG0003032	0	1	0	1	2
OG0003033	0	1	1	0	2
OG0003034	0	1	0	1	2
OG0003035	0	1	0	1	2
OG0003036	0	1	0	1	2
OG0003037	0	1	0	1	2
OG0003038	0	1	0	1	2
OG0003039	0	1	0	1	2
OG0003040	0	1	1	0	2
OG0003041	0	1	0	1	2
OG0003042	0	1	0	1	2
OG0003043	0	1	1	0	2
OG0003044	0	1	0	1	2
OG0003045	0	1	0	1	2
OG0003046	0	1	1	0	2
OG0003047	0	1	0	1	2
OG0003048	0	1	0	1	2
OG0003049	0	2	0	0	2
OG0003050	0	1	0	1	2
OG0003051	0	1	0	1	2
OG0003052	0	1	1	0	2
OG0003053	0	2	0	0	2
OG0003054	0	2	0	0	2
OG0003055	0	2	0	0	2
OG0003056	0	1	0	1	2
OG0003057	0	1	0	1	2
OG0003058	0	1	0	1	2
OG0003059	0	1	0	1	2
OG0003060	0	1	0	1	2
OG0003061	0	1	0	1	2
OG0003062	0	1	0	1	2
OG0003063	0	1	0	1	2
OG0003064	0	1	1	0	2
OG0003065	0	1	0	1	2
OG0003066	0	1	0	1	2
OG0003067	0	2	0	0	2
OG0003068	0	1	0	1	2
OG0003069	0	1	1	0	2
OG0003070	0	1	1	0	2
OG0003071	0	2	0	0	2
OG0003072	0	2	0	0	2
OG0003073	0	1	0	1	2
OG0003074	0	1	0	1	2
OG0003075	0	1	1	0	2
OG0003076	0	1	0	1	2
OG0003077	0	1	0	1	2
OG0003078	0	1	1	0	2
OG0003079	0	1	0	1	2
OG0003080	0	1	0	1	2
OG0003081	0	1	0	1	2
OG0003082	0	1	0	1	2
OG0003083	0	1	1	0	2
OG0003084	0	1	0	1	2
OG0003085	0	1	0	1	2
OG0003086	0	1	0	1	2
OG0003087	0	1	1	0	2
OG0003088	0	1	0	1	2
OG0003089	0	1	1	0	2
OG0003090	0	1	0	1	2
OG0003091	0	1	0	1	2
OG0003092	0	1	0	1	2
OG0003093	0	1	1	0	2
OG0003094	0	1	1	0	2
OG0003095	0	1	0	1	2
OG0003096	0	1	0	1	2
OG0003097	0	1	0	1	2
OG0003098	0	1	1	0	2
OG0003099	0	1	0	1	2
OG0003100	0	1	1	0	2
OG0003101	0	1	0	1	2
OG0003102	0	1	0	1	2
OG0003103	0	1	1	0	2
OG0003104	0	1	0	1	2
OG0003105	0	1	0	1	2
OG0003106	0	1	0	1	2
OG0003107	0	1	0	1	2
OG0003108	0	1	0	1	2
OG0003109	0	1	1	0	2
OG0003110	0	1	1	0	2
OG0003111	0	1	0	1	2
OG0003112	0	1	0	1	2
OG0003113	0	1	0	1	2
OG0003114	0	1	0	1	2
OG0003115	0	1	0	1	2
OG0003116	0	1	1	0	2
OG0003117	0	1	1	0	2
OG0003118	0	1	1	0	2
OG0003119	0	1	1	0	2
OG0003120	0	1	0	1	2
OG0003121	0	2	0	0	2
OG0003122	0	1	0	1	2
OG0003123	0	1	0	1	2
OG0003124	0	1	0	1	2
OG0003125	0	1	0	1	2
OG0003126	0	1	0	1	2
OG0003127	0	1	0	1	2
OG0003128	0	1	0	1	2
OG0003129	0	1	0	1	2
OG0003130	0	1	0	1	2
OG0003131	0	1	0	1	2
OG0003132	0	1	0	1	2
OG0003133	0	1	1	0	2
OG0003134	0	1	0	1	2
OG0003135	0	1	0	1	2
OG0003136	0	1	1	0	2
OG0003137	0	1	0	1	2
OG0003138	0	1	1	0	2
OG0003139	0	1	1	0	2
OG0003140	0	1	0	1	2
OG0003141	0	1	1	0	2
OG0003142	0	1	0	1	2
OG0003143	0	1	0	1	2
OG0003144	0	1	0	1	2
OG0003145	0	1	0	1	2
OG0003146	0	1	0	1	2
OG0003147	0	1	1	0	2
OG0003148	0	1	0	1	2
OG0003149	0	1	0	1	2
OG0003150	0	1	1	0	2
OG0003151	0	2	0	0	2
OG0003152	0	1	0	1	2
OG0003153	0	1	1	0	2
OG0003154	0	1	1	0	2
OG0003155	0	1	0	1	2
OG0003156	0	1	0	1	2
OG0003157	0	2	0	0	2
OG0003158	0	1	0	1	2
OG0003159	0	1	1	0	2
OG0003160	0	1	1	0	2
OG0003161	0	1	0	1	2
OG0003162	0	1	1	0	2
OG0003163	0	1	1	0	2
OG0003164	0	1	0	1	2
OG0003165	0	1	1	0	2
OG0003166	0	1	0	1	2
OG0003167	0	1	1	0	2
OG0003168	0	1	1	0	2
OG0003169	0	1	0	1	2
OG0003170	0	1	0	1	2
OG0003171	0	1	0	1	2
OG0003172	0	1	1	0	2
OG0003173	0	1	0	1	2
OG0003174	0	1	0	1	2
OG0003175	0	1	0	1	2
OG0003176	0	1	0	1	2
OG0003177	0	1	0	1	2
OG0003178	0	1	0	1	2
OG0003179	0	1	1	0	2
OG0003180	0	1	1	0	2
OG0003181	0	1	0	1	2
OG0003182	0	1	1	0	2
OG0003183	0	1	1	0	2
OG0003184	0	1	0	1	2
OG0003185	0	1	0	1	2
OG0003186	0	1	0	1	2
OG0003187	0	1	0	1	2
OG0003188	0	1	0	1	2
OG0003189	0	1	1	0	2
OG0003190	0	1	0	1	2
OG0003191	0	1	1	0	2
OG0003192	0	1	0	1	2
OG0003193	0	1	0	1	2
OG0003194	0	1	0	1	2
OG0003195	0	2	0	0	2
OG0003196	0	1	1	0	2
OG0003197	0	1	0	1	2
OG0003198	0	1	0	1	2
OG0003199	0	1	0	1	2
OG0003200	0	1	1	0	2
OG0003201	0	1	0	1	2
OG0003202	0	1	0	1	2
OG0003203	0	1	0	1	2
OG0003204	0	1	0	1	2
OG0003205	0	2	0	0	2
OG0003206	0	2	0	0	2
OG0003207	0	1	1	0	2
OG0003208	0	1	0	1	2
OG0003209	0	1	1	0	2
OG0003210	0	1	0	1	2
OG0003211	0	1	0	1	2
OG0003212	0	1	0	1	2
OG0003213	0	1	0	1	2
OG0003214	0	1	0	1	2
OG0003215	0	1	1	0	2
OG0003216	0	1	0	1	2
OG0003217	0	1	0	1	2
OG0003218	0	1	1	0	2
OG0003219	0	1	1	0	2
OG0003220	0	1	0	1	2
OG0003221	0	1	0	1	2
OG0003222	0	1	0	1	2
OG0003223	0	1	0	1	2
OG0003224	0	1	0	1	2
OG0003225	0	1	1	0	2
OG0003226	0	1	0	1	2
OG0003227	0	1	0	1	2
OG0003228	0	1	0	1	2
OG0003229	0	1	0	1	2
OG0003230	0	0	2	0	2
OG0003231	0	0	2	0	2
OG0003232	0	0	2	0	2
OG0003233	0	0	2	0	2
OG0003234	0	0	2	0	2
OG0003235	0	0	1	1	2
OG0003236	0	0	2	0	2
OG0003237	0	0	2	0	2
OG0003238	0	0	2	0	2
OG0003239	0	0	1	1	2
OG0003240	0	0	1	1	2
OG0003241	0	0	1	1	2
OG0003242	0	0	1	1	2
OG0003243	0	0	1	1	2
OG0003244	0	0	1	1	2
OG0003245	0	0	1	1	2
OG0003246	0	0	1	1	2
OG0003247	0	0	1	1	2
OG0003248	0	0	2	0	2
OG0003249	0	0	1	1	2
OG0003250	0	0	1	1	2
OG0003251	0	0	1	1	2
OG0003252	0	0	1	1	2
OG0003253	0	0	1	1	2
OG0003254	0	0	1	1	2
OG0003255	0	0	1	1	2
OG0003256	0	0	1	1	2
OG0003257	0	0	1	1	2
OG0003258	0	0	1	1	2
OG0003259	0	0	1	1	2
OG0003260	0	0	1	1	2
OG0003261	0	0	1	1	2
OG0003262	0	0	1	1	2
OG0003263	0	0	1	1	2
OG0003264	0	0	2	0	2
OG0003265	0	0	1	1	2
OG0003266	0	0	1	1	2
OG0003267	0	0	1	1	2
OG0003268	0	0	1	1	2
OG0003269	0	0	1	1	2
OG0003270	0	0	2	0	2
OG0003271	0	0	2	0	2
OG0003272	0	0	2	0	2
OG0003273	0	0	2	0	2
OG0003274	0	0	2	0	2
OG0003275	0	0	2	0	2
OG0003276	0	0	2	0	2
OG0003277	0	0	1	1	2
OG0003278	0	0	1	1	2
OG0003279	0	0	2	0	2
OG0003280	0	0	1	1	2
OG0003281	0	0	1	1	2
OG0003282	0	0	1	1	2
OG0003283	0	0	1	1	2
OG0003284	0	0	1	1	2
OG0003285	0	0	1	1	2
OG0003286	0	0	1	1	2
OG0003287	0	0	1	1	2
OG0003288	0	0	1	1	2
OG0003289	0	0	1	1	2
OG0003290	0	0	1	1	2
OG0003291	0	0	2	0	2
OG0003292	0	0	2	0	2
OG0003293	0	0	1	1	2
OG0003294	0	0	1	1	2
OG0003295	0	0	1	1	2
OG0003296	0	0	2	0	2
OG0003297	0	0	1	1	2
OG0003298	0	0	2	0	2
OG0003299	0	0	1	1	2
OG0003300	0	0	1	1	2
OG0003301	0	0	1	1	2
OG0003302	0	0	1	1	2
OG0003303	0	0	2	0	2
OG0003304	0	0	2	0	2
OG0003305	0	0	1	1	2
OG0003306	0	0	1	1	2
OG0003307	0	0	2	0	2
OG0003308	0	0	2	0	2
OG0003309	0	0	2	0	2
OG0003310	0	0	2	0	2
OG0003311	0	0	1	1	2
OG0003312	0	0	1	1	2
OG0003313	0	0	1	1	2
OG0003314	0	0	1	1	2
OG0003315	0	0	1	1	2
OG0003316	0	0	1	1	2
OG0003317	0	0	1	1	2
OG0003318	0	0	1	1	2
OG0003319	0	0	1	1	2
OG0003320	0	0	1	1	2
OG0003321	0	0	2	0	2
OG0003322	0	0	2	0	2
OG0003323	0	0	2	0	2
OG0003324	0	0	1	1	2
OG0003325	0	0	1	1	2
OG0003326	0	0	1	1	2
OG0003327	0	0	1	1	2
OG0003328	0	0	1	1	2
OG0003329	0	0	1	1	2
OG0003330	0	0	2	0	2
OG0003331	0	0	2	0	2
OG0003332	0	0	1	1	2
OG0003333	0	0	1	1	2
OG0003334	0	0	1	1	2
OG0003335	0	0	1	1	2
OG0003336	0	0	1	1	2
OG0003337	0	0	1	1	2
OG0003338	0	0	1	1	2
OG0003339	0	0	1	1	2
OG0003340	0	0	2	0	2
OG0003341	0	0	1	1	2
OG0003342	0	0	2	0	2
OG0003343	0	0	1	1	2
OG0003344	0	0	1	1	2
OG0003345	0	0	1	1	2
OG0003346	0	0	1	1	2
OG0003347	0	0	1	1	2
OG0003348	0	0	1	1	2
OG0003349	0	0	2	0	2
OG0003350	0	0	1	1	2
OG0003351	0	0	2	0	2
OG0003352	0	0	1	1	2
OG0003353	0	0	1	1	2
OG0003354	0	0	2	0	2
OG0003355	0	0	2	0	2
OG0003356	0	0	1	1	2
OG0003357	0	0	1	1	2
OG0003358	0	0	1	1	2
OG0003359	0	0	1	1	2
OG0003360	0	0	2	0	2
OG0003361	0	0	1	1	2
OG0003362	0	0	2	0	2
OG0003363	0	0	1	1	2
OG0003364	0	0	2	0	2
OG0003365	0	0	1	1	2
OG0003366	0	0	1	1	2
OG0003367	0	0	1	1	2
OG0003368	0	0	1	1	2
OG0003369	0	0	1	1	2
OG0003370	0	0	2	0	2
OG0003371	0	0	1	1	2
OG0003372	0	0	2	0	2
OG0003373	0	0	2	0	2
OG0003374	0	0	2	0	2
OG0003375	0	0	2	0	2
OG0003376	0	0	2	0	2
OG0003377	0	0	2	0	2
OG0003378	0	0	2	0	2
OG0003379	0	0	1	1	2
OG0003380	0	0	1	1	2
OG0003381	0	0	1	1	2
OG0003382	0	0	1	1	2
OG0003383	0	0	1	1	2
OG0003384	0	0	2	0	2
OG0003385	0	0	1	1	2
OG0003386	0	0	2	0	2
OG0003387	0	0	1	1	2
OG0003388	0	0	1	1	2
OG0003389	0	0	2	0	2
OG0003390	0	0	2	0	2
OG0003391	0	0	1	1	2
OG0003392	0	0	1	1	2
OG0003393	0	0	2	0	2
OG0003394	0	0	2	0	2
OG0003395	0	0	2	0	2
OG0003396	0	0	1	1	2
OG0003397	0	0	1	1	2
OG0003398	0	0	1	1	2
OG0003399	0	0	1	1	2
OG0003400	0	0	1	1	2
OG0003401	0	0	1	1	2
OG0003402	0	0	1	1	2
OG0003403	0	0	1	1	2
OG0003404	0	0	2	0	2
OG0003405	0	0	1	1	2
OG0003406	0	0	1	1	2
OG0003407	0	0	1	1	2
OG0003408	0	0	1	1	2
OG0003409	0	0	1	1	2
OG0003410	0	0	1	1	2
OG0003411	0	0	1	1	2
OG0003412	0	0	1	1	2
OG0003413	0	0	2	0	2
OG0003414	0	0	1	1	2
OG0003415	0	0	2	0	2
OG0003416	0	0	1	1	2
OG0003417	0	0	1	1	2
OG0003418	0	0	2	0	2
OG0003419	0	0	1	1	2
OG0003420	0	0	1	1	2
OG0003421	0	0	2	0	2
OG0003422	0	0	1	1	2
OG0003423	0	0	1	1	2
OG0003424	0	0	1	1	2
OG0003425	0	0	1	1	2
OG0003426	0	0	1	1	2
OG0003427	0	0	2	0	2
OG0003428	0	0	1	1	2
OG0003429	0	0	1	1	2
OG0003430	0	0	1	1	2
OG0003431	0	0	2	0	2
OG0003432	0	0	2	0	2
OG0003433	0	0	2	0	2
OG0003434	0	0	2	0	2
OG0003435	0	0	1	1	2
OG0003436	0	0	1	1	2
OG0003437	0	0	1	1	2
OG0003438	0	0	2	0	2
OG0003439	0	0	1	1	2
OG0003440	0	0	2	0	2
OG0003441	0	0	1	1	2
OG0003442	0	0	1	1	2
OG0003443	0	0	1	1	2
OG0003444	0	0	2	0	2
OG0003445	0	0	2	0	2
OG0003446	0	0	1	1	2
OG0003447	0	0	1	1	2
OG0003448	0	0	1	1	2
OG0003449	0	0	1	1	2
OG0003450	0	0	1	1	2
OG0003451	0	0	1	1	2
OG0003452	0	0	1	1	2
OG0003453	0	0	2	0	2
OG0003454	0	0	2	0	2
OG0003455	0	0	1	1	2
OG0003456	0	0	1	1	2
OG0003457	0	0	1	1	2
OG0003458	0	0	1	1	2
OG0003459	0	0	1	1	2
OG0003460	0	0	1	1	2
OG0003461	0	0	1	1	2
OG0003462	0	0	1	1	2
OG0003463	0	0	2	0	2
OG0003464	0	0	1	1	2
OG0003465	0	0	1	1	2
OG0003466	0	0	1	1	2
OG0003467	0	0	1	1	2
OG0003468	0	0	1	1	2
OG0003469	0	0	1	1	2
OG0003470	0	0	2	0	2
OG0003471	0	0	1	1	2
OG0003472	0	0	1	1	2
OG0003473	0	0	1	1	2
OG0003474	0	0	1	1	2
OG0003475	0	0	2	0	2
OG0003476	0	0	1	1	2
OG0003477	0	0	1	1	2
OG0003478	0	0	1	1	2
OG0003479	0	0	1	1	2
OG0003480	0	0	1	1	2
OG0003481	0	0	2	0	2
OG0003482	0	0	1	1	2
OG0003483	0	0	1	1	2
OG0003484	0	0	1	1	2
OG0003485	0	0	1	1	2
OG0003486	0	0	1	1	2
OG0003487	0	0	1	1	2
OG0003488	0	0	1	1	2
OG0003489	0	0	1	1	2
OG0003490	0	0	1	1	2
OG0003491	0	0	1	1	2
OG0003492	0	0	1	1	2
OG0003493	0	0	1	1	2
OG0003494	0	0	1	1	2
OG0003495	0	0	1	1	2
OG0003496	0	0	2	0	2
OG0003497	0	0	1	1	2
OG0003498	0	0	1	1	2
OG0003499	0	0	1	1	2
OG0003500	0	0	1	1	2
OG0003501	0	0	1	1	2
OG0003502	0	0	1	1	2
OG0003503	0	0	1	1	2
OG0003504	0	0	1	1	2
OG0003505	0	0	1	1	2
OG0003506	0	0	1	1	2
OG0003507	0	0	1	1	2
OG0003508	0	0	1	1	2
OG0003509	0	0	1	1	2
OG0003510	0	0	1	1	2
OG0003511	0	0	1	1	2
OG0003512	0	0	1	1	2
OG0003513	0	0	1	1	2
OG0003514	0	0	1	1	2
OG0003515	0	0	1	1	2
OG0003516	0	0	1	1	2
OG0003517	0	0	1	1	2
OG0003518	0	0	1	1	2
OG0003519	0	0	2	0	2
OG0003520	0	0	2	0	2
OG0003521	0	0	2	0	2
OG0003522	0	0	2	0	2
OG0003523	0	0	1	1	2
OG0003524	0	0	1	1	2
OG0003525	0	0	1	1	2
OG0003526	0	0	1	1	2
OG0003527	0	0	1	1	2
OG0003528	0	0	1	1	2
OG0003529	0	0	1	1	2
OG0003530	0	0	1	1	2
OG0003531	0	0	1	1	2
OG0003532	0	0	1	1	2
OG0003533	0	0	1	1	2
OG0003534	0	0	1	1	2
OG0003535	0	0	1	1	2
OG0003536	0	0	1	1	2
OG0003537	0	0	2	0	2
OG0003538	0	0	2	0	2
OG0003539	0	0	1	1	2
OG0003540	0	0	1	1	2
OG0003541	0	0	1	1	2
OG0003542	0	0	2	0	2
OG0003543	0	0	1	1	2
OG0003544	0	0	1	1	2
OG0003545	0	0	2	0	2
OG0003546	0	0	2	0	2
OG0003547	0	0	1	1	2
OG0003548	0	0	1	1	2
OG0003549	0	0	2	0	2
OG0003550	0	0	1	1	2
OG0003551	0	0	1	1	2
OG0003552	0	0	1	1	2
OG0003553	0	0	1	1	2
OG0003554	0	0	1	1	2
OG0003555	0	0	1	1	2
OG0003556	0	0	1	1	2
OG0003557	0	0	1	1	2
OG0003558	0	0	1	1	2
OG0003559	0	0	1	1	2
OG0003560	0	0	2	0	2
OG0003561	0	0	1	1	2
OG0003562	0	0	1	1	2
OG0003563	0	0	1	1	2
OG0003564	0	0	1	1	2
OG0003565	0	0	1	1	2
OG0003566	0	0	1	1	2
OG0003567	0	0	1	1	2
OG0003568	0	0	1	1	2
OG0003569	0	0	1	1	2
OG0003570	0	0	1	1	2
OG0003571	0	0	1	1	2
OG0003572	0	0	1	1	2
OG0003573	0	0	1	1	2
OG0003574	0	0	1	1	2
OG0003575	0	0	1	1	2
OG0003576	0	0	1	1	2
OG0003577	0	0	1	1	2
OG0003578	0	0	1	1	2
OG0003579	0	0	2	0	2
OG0003580	0	0	1	1	2
OG0003581	0	0	1	1	2
OG0003582	0	0	1	1	2
OG0003583	0	0	1	1	2
OG0003584	0	0	1	1	2
OG0003585	0	0	1	1	2
OG0003586	0	0	1	1	2
OG0003587	0	0	1	1	2
OG0003588	0	0	1	1	2
OG0003589	0	0	1	1	2
OG0003590	0	0	1	1	2
OG0003591	0	0	1	1	2
OG0003592	0	0	1	1	2
OG0003593	0	0	1	1	2
OG0003594	0	0	1	1	2
OG0003595	0	0	2	0	2
OG0003596	0	0	2	0	2
OG0003597	0	0	1	1	2
OG0003598	0	0	1	1	2
OG0003599	0	0	1	1	2
OG0003600	0	0	1	1	2
OG0003601	0	0	2	0	2
OG0003602	0	0	1	1	2
OG0003603	0	0	1	1	2
OG0003604	0	0	1	1	2
OG0003605	0	0	1	1	2
OG0003606	0	0	2	0	2
OG0003607	0	0	1	1	2
OG0003608	0	0	1	1	2
OG0003609	0	0	1	1	2
OG0003610	0	0	1	1	2
OG0003611	0	0	1	1	2
OG0003612	0	0	1	1	2
OG0003613	0	0	1	1	2
OG0003614	0	0	1	1	2
OG0003615	0	0	1	1	2
OG0003616	0	0	2	0	2
OG0003617	0	0	1	1	2
OG0003618	0	0	1	1	2
OG0003619	0	0	1	1	2
OG0003620	0	0	1	1	2
OG0003621	0	0	1	1	2
OG0003622	0	0	1	1	2
OG0003623	0	0	1	1	2
OG0003624	0	0	1	1	2
OG0003625	0	0	2	0	2
OG0003626	0	0	1	1	2
OG0003627	0	0	1	1	2
OG0003628	0	0	1	1	2
OG0003629	0	0	1	1	2
OG0003630	0	0	1	1	2
OG0003631	0	0	1	1	2
OG0003632	0	0	1	1	2
OG0003633	0	0	1	1	2
OG0003634	0	0	1	1	2
OG0003635	0	0	1	1	2
OG0003636	0	0	1	1	2
OG0003637	0	0	1	1	2
OG0003638	0	0	1	1	2
OG0003639	0	0	1	1	2
OG0003640	0	0	1	1	2
OG0003641	0	0	1	1	2
OG0003642	0	0	1	1	2
OG0003643	0	0	1	1	2
OG0003644	0	0	2	0	2
OG0003645	0	0	2	0	2
OG0003646	0	0	2	0	2
OG0003647	0	0	1	1	2
OG0003648	0	0	2	0	2
OG0003649	0	0	2	0	2
OG0003650	0	0	1	1	2
OG0003651	0	0	2	0	2
OG0003652	0	0	1	1	2
OG0003653	0	0	2	0	2
OG0003654	0	0	1	1	2
OG0003655	0	0	2	0	2
OG0003656	0	0	2	0	2
OG0003657	0	0	2	0	2
OG0003658	0	0	1	1	2
OG0003659	0	0	1	1	2
OG0003660	0	0	1	1	2
OG0003661	0	0	1	1	2
OG0003662	0	0	1	1	2
OG0003663	0	0	1	1	2
OG0003664	0	0	1	1	2
OG0003665	0	0	1	1	2
OG0003666	0	0	1	1	2
OG0003667	0	0	1	1	2
OG0003668	0	0	1	1	2
OG0003669	0	0	1	1	2
OG0003670	0	0	1	1	2
OG0003671	0	0	1	1	2
OG0003672	0	0	2	0	2
OG0003673	0	0	1	1	2
OG0003674	0	0	1	1	2
OG0003675	0	0	2	0	2
OG0003676	0	0	2	0	2
OG0003677	0	0	2	0	2
OG0003678	0	0	1	1	2
OG0003679	0	0	2	0	2
OG0003680	0	0	2	0	2
OG0003681	0	0	2	0	2
OG0003682	0	0	1	1	2
OG0003683	0	0	1	1	2
OG0003684	0	0	1	1	2
OG0003685	0	0	1	1	2
OG0003686	0	0	2	0	2
OG0003687	0	0	1	1	2
OG0003688	0	0	1	1	2
OG0003689	0	0	1	1	2
OG0003690	0	0	1	1	2
OG0003691	0	0	1	1	2
OG0003692	0	0	1	1	2
OG0003693	0	0	1	1	2
OG0003694	0	0	2	0	2
OG0003695	0	0	1	1	2
OG0003696	0	0	1	1	2
OG0003697	0	0	1	1	2
OG0003698	0	0	2	0	2
OG0003699	0	0	1	1	2
OG0003700	0	0	1	1	2
OG0003701	0	0	1	1	2
OG0003702	0	0	1	1	2
OG0003703	0	0	1	1	2
OG0003704	0	0	1	1	2
OG0003705	0	0	2	0	2
OG0003706	0	0	1	1	2
OG0003707	0	0	1	1	2
OG0003708	0	0	1	1	2
OG0003709	0	0	1	1	2
OG0003710	0	0	1	1	2
OG0003711	0	0	2	0	2
OG0003712	0	0	1	1	2
OG0003713	0	0	1	1	2
OG0003714	0	0	2	0	2
OG0003715	0	0	1	1	2
OG0003716	0	0	1	1	2
OG0003717	0	0	1	1	2
OG0003718	0	0	1	1	2
OG0003719	0	0	1	1	2
OG0003720	0	0	2	0	2
OG0003721	0	0	1	1	2
OG0003722	0	0	2	0	2
OG0003723	0	0	1	1	2
OG0003724	0	0	1	1	2
OG0003725	0	0	1	1	2
OG0003726	0	0	1	1	2
OG0003727	0	0	1	1	2
OG0003728	0	0	1	1	2
OG0003729	0	0	1	1	2
OG0003730	0	0	1	1	2
OG0003731	0	0	1	1	2
OG0003732	0	0	1	1	2
OG0003733	0	0	1	1	2
OG0003734	0	0	1	1	2
OG0003735	0	0	1	1	2
OG0003736	0	0	1	1	2
OG0003737	0	0	1	1	2
OG0003738	0	0	1	1	2
OG0003739	0	0	1	1	2
OG0003740	0	0	1	1	2
OG0003741	0	0	1	1	2
OG0003742	0	0	1	1	2
OG0003743	0	0	1	1	2
OG0003744	0	0	1	1	2
OG0003745	0	0	2	0	2
OG0003746	0	0	1	1	2
OG0003747	0	0	1	1	2
OG0003748	0	0	1	1	2
OG0003749	0	0	2	0	2
OG0003750	0	0	2	0	2
OG0003751	0	0	1	1	2
OG0003752	0	0	1	1	2
OG0003753	0	0	1	1	2
OG0003754	0	0	1	1	2
OG0003755	0	0	1	1	2
OG0003756	0	0	1	1	2
OG0003757	0	0	1	1	2
OG0003758	0	0	1	1	2
OG0003759	0	0	1	1	2
OG0003760	0	0	1	1	2
OG0003761	0	0	1	1	2
OG0003762	0	0	1	1	2
OG0003763	0	0	1	1	2
OG0003764	0	0	1	1	2
OG0003765	0	0	2	0	2
OG0003766	0	0	1	1	2
OG0003767	0	0	2	0	2
OG0003768	0	0	1	1	2
OG0003769	0	0	1	1	2
OG0003770	0	0	1	1	2
OG0003771	0	0	1	1	2
OG0003772	0	0	1	1	2
OG0003773	0	0	2	0	2
OG0003774	0	0	1	1	2
OG0003775	0	0	1	1	2
OG0003776	0	0	1	1	2
OG0003777	0	0	1	1	2
OG0003778	0	0	2	0	2
OG0003779	0	0	1	1	2
OG0003780	0	0	2	0	2
OG0003781	0	0	1	1	2
OG0003782	0	0	1	1	2
OG0003783	0	0	2	0	2
OG0003784	0	0	2	0	2
OG0003785	0	0	2	0	2
OG0003786	0	0	1	1	2
OG0003787	0	0	1	1	2
OG0003788	0	0	1	1	2
OG0003789	0	0	1	1	2
OG0003790	0	0	1	1	2
OG0003791	0	0	1	1	2
OG0003792	0	0	1	1	2
OG0003793	0	0	1	1	2
OG0003794	0	0	1	1	2
OG0003795	0	0	1	1	2
OG0003796	0	0	1	1	2
OG0003797	0	0	1	1	2
OG0003798	0	0	1	1	2
OG0003799	0	0	1	1	2
OG0003800	0	0	1	1	2
OG0003801	0	0	2	0	2
OG0003802	0	0	1	1	2
OG0003803	0	0	2	0	2
OG0003804	0	0	2	0	2
OG0003805	0	0	1	1	2
OG0003806	0	0	1	1	2
OG0003807	0	0	2	0	2
OG0003808	0	0	1	1	2
OG0003809	0	0	2	0	2
OG0003810	0	0	1	1	2
OG0003811	0	0	1	1	2
OG0003812	0	0	1	1	2
OG0003813	0	0	1	1	2
OG0003814	0	0	1	1	2
OG0003815	0	0	1	1	2
OG0003816	0	0	1	1	2
OG0003817	0	0	1	1	2
OG0003818	0	0	2	0	2
OG0003819	0	0	1	1	2
OG0003820	0	0	1	1	2
OG0003821	0	0	1	1	2
OG0003822	0	0	1	1	2
OG0003823	0	0	1	1	2
OG0003824	0	0	1	1	2
OG0003825	0	0	1	1	2
OG0003826	0	0	1	1	2
OG0003827	0	0	1	1	2
OG0003828	0	0	1	1	2
OG0003829	0	0	1	1	2
OG0003830	0	0	1	1	2
OG0003831	0	0	1	1	2
OG0003832	0	0	1	1	2
OG0003833	0	0	1	1	2
OG0003834	0	0	2	0	2
OG0003835	0	0	2	0	2
OG0003836	0	0	2	0	2
OG0003837	0	0	1	1	2
OG0003838	0	0	2	0	2
OG0003839	0	0	2	0	2
OG0003840	0	0	1	1	2
OG0003841	0	0	1	1	2
OG0003842	0	0	1	1	2
OG0003843	0	0	1	1	2
OG0003844	0	0	1	1	2
OG0003845	0	0	1	1	2
OG0003846	0	0	1	1	2
OG0003847	0	0	0	2	2
OG0003848	0	0	0	2	2
OG0003849	0	0	0	2	2
OG0003850	0	0	0	2	2
OG0003851	0	0	0	2	2
OG0003852	0	0	0	2	2
OG0003853	0	0	0	2	2
OG0003854	0	0	0	2	2
OG0003855	0	0	0	2	2
OG0003856	0	0	0	2	2
OG0003857	0	0	0	2	2
OG0003858	0	0	0	2	2
OG0003859	0	0	0	2	2
OG0003860	0	0	0	2	2
OG0003861	0	0	0	2	2
OG0003862	0	0	0	2	2
OG0003863	0	0	0	2	2
OG0003864	0	0	0	2	2
OG0003865	0	0	0	2	2
OG0003866	0	0	0	2	2
OG0003867	0	0	0	2	2
OG0003868	0	0	0	2	2
OG0003869	0	0	0	2	2
OG0003870	0	0	0	2	2
OG0003871	0	0	0	2	2
OG0003872	0	0	0	2	2
OG0003873	0	0	0	2	2
OG0003874	0	0	0	2	2
OG0003875	0	0	0	2	2
OG0003876	0	0	0	2	2
OG0003877	0	0	0	2	2
OG0003878	0	0	0	2	2
OG0003879	0	0	0	2	2
OG0003880	0	0	0	2	2
OG0003881	0	0	0	2	2
OG0003882	0	0	0	2	2
OG0003883	0	0	0	2	2
OG0003884	0	0	0	2	2
OG0003885	0	0	0	2	2
OG0003886	0	0	0	2	2
OG0003887	0	0	0	2	2
OG0003888	0	0	0	2	2
OG0003889	0	0	0	2	2
OG0003890	0	0	0	2	2
OG0003891	0	0	0	2	2
OG0003892	0	0	0	2	2
OG0003893	0	0	0	2	2
OG0003894	0	0	0	2	2
OG0003895	0	0	0	2	2
OG0003896	0	0	0	2	2
OG0003897	0	0	0	2	2
OG0003898	0	0	0	2	2
OG0003899	0	0	0	2	2
OG0003900	0	0	0	2	2
OG0003901	0	0	0	2	2
OG0003902	0	0	0	2	2
OG0003903	0	0	0	2	2
OG0003904	0	0	0	2	2
OG0003905	0	0	0	2	2
OG0003906	0	0	0	2	2
OG0003907	0	0	0	2	2
OG0003908	0	0	0	2	2
OG0003909	0	0	0	2	2
OG0003910	0	0	0	2	2
OG0003911	0	0	0	2	2
OG0003912	0	0	0	2	2
OG0003913	0	0	0	2	2
OG0003914	0	0	0	2	2
OG0003915	0	0	0	2	2
OG0003916	0	0	0	2	2
OG0003917	0	0	0	2	2
OG0003918	0	0	0	2	2
OG0003919	0	0	0	2	2
OG0003920	0	0	0	2	2
OG0003921	0	0	0	2	2
OG0003922	0	0	0	2	2
OG0003923	0	0	0	2	2
OG0003924	0	0	0	2	2
OG0003925	0	0	0	2	2
OG0003926	0	0	0	2	2
OG0003927	0	0	0	2	2
OG0003928	0	0	0	2	2
OG0003929	0	0	0	2	2
OG0003930	0	0	0	2	2
OG0003931	0	0	0	2	2
OG0003932	0	0	0	2	2
OG0003933	0	0	0	2	2
OG0003934	0	0	0	2	2
OG0003935	0	0	0	2	2
OG0003936	0	0	0	2	2
OG0003937	0	0	0	2	2
OG0003938	0	0	0	2	2
OG0003939	0	0	0	2	2
OG0003940	0	0	0	2	2
OG0003941	0	0	0	2	2
OG0003942	0	0	0	2	2
OG0003943	0	0	0	2	2
OG0003944	0	0	0	2	2
OG0003945	0	0	0	2	2
OG0003946	0	0	0	2	2
OG0003947	0	0	0	2	2
OG0003948	0	0	0	2	2
OG0003949	0	0	0	2	2
OG0003950	0	0	0	2	2
OG0003951	0	0	0	2	2
OG0003952	0	0	0	2	2
OG0003953	0	0	0	2	2
OG0003954	0	0	0	2	2
OG0003955	0	0	0	2	2
OG0003956	0	0	0	2	2
OG0003957	0	0	0	2	2
OG0003958	0	0	0	2	2
OG0003959	0	0	0	2	2
OG0003960	0	0	0	2	2
OG0003961	0	0	0	2	2
OG0003962	0	0	0	2	2
OG0003963	0	0	0	2	2
OG0003964	0	0	0	2	2
OG0003965	0	0	0	2	2
OG0003966	0	0	0	2	2
OG0003967	0	0	0	2	2
OG0003968	0	0	0	2	2
OG0003969	0	0	0	2	2
OG0003970	0	0	0	2	2
OG0003971	0	0	0	2	2
OG0003972	0	0	0	2	2
OG0003973	0	0	0	2	2
OG0003974	0	0	0	2	2
OG0003975	0	0	0	2	2
OG0003976	0	0	0	2	2
OG0003977	0	0	0	2	2
OG0003978	0	0	0	2	2
OG0003979	0	0	0	2	2
OG0003980	0	0	0	2	2
OG0003981	0	0	0	2	2
OG0003982	0	0	0	2	2
OG0003983	0	0	0	2	2
OG0003984	0	0	0	2	2
OG0003985	0	0	0	2	2
OG0003986	0	0	0	2	2
OG0003987	0	0	0	2	2
OG0003988	0	0	0	2	2
OG0003989	0	0	0	2	2
OG0003990	0	0	0	2	2
OG0003991	0	0	0	2	2
OG0003992	0	0	0	2	2
OG0003993	0	0	0	2	2
OG0003994	0	0	0	2	2
OG0003995	0	0	0	2	2
OG0003996	0	0	0	2	2
OG0003997	0	0	0	2	2
OG0003998	0	0	0	2	2
OG0003999	0	0	0	2	2
OG0004000	0	0	0	2	2
OG0004001	0	0	0	2	2
OG0004002	0	0	0	2	2
OG0004003	0	0	0	2	2
OG0004004	0	0	0	2	2
OG0004005	0	0	0	2	2
OG0004006	0	0	0	2	2
OG0004007	0	0	0	2	2
OG0004008	0	0	0	2	2
OG0004009	0	0	0	2	2
OG0004010	0	0	0	2	2
OG0004011	0	0	0	2	2
OG0004012	0	0	0	2	2
OG0004013	0	0	0	2	2
OG0004014	0	0	0	2	2
OG0004015	0	0	0	2	2
OG0004016	0	0	0	2	2
OG0004017	0	0	0	2	2
OG0004018	0	0	0	2	2
OG0004019	0	0	0	2	2
OG0004020	0	0	0	2	2
OG0004021	0	0	0	2	2
OG0004022	0	0	0	2	2
OG0004023	0	0	0	2	2
OG0004024	0	0	0	2	2
OG0004025	0	0	0	2	2
OG0004026	0	0	0	2	2
OG0004027	0	0	0	2	2
OG0004028	0	0	0	2	2
OG0004029	0	0	0	2	2
OG0004030	0	0	0	2	2
OG0004031	0	0	0	2	2
OG0004032	0	0	0	2	2
OG0004033	0	0	0	2	2
OG0004034	0	0	0	2	2
OG0004035	0	0	0	2	2
OG0004036	0	0	0	2	2
OG0004037	0	0	0	2	2
OG0004038	0	0	0	2	2
OG0004039	0	0	0	2	2
OG0004040	0	0	0	2	2
OG0004041	0	0	0	2	2
OG0004042	0	0	0	2	2
OG0004043	0	0	0	2	2
OG0004044	0	0	0	2	2
OG0004045	0	0	0	2	2
OG0004046	0	0	0	2	2
OG0004047	0	0	0	2	2
OG0004048	0	0	0	2	2
OG0004049	0	0	0	2	2
OG0004050	0	0	0	2	2
OG0004051	0	0	0	2	2
OG0004052	0	0	0	2	2
OG0004053	0	0	0	2	2
OG0004054	0	0	0	2	2
OG0004055	0	0	0	2	2
OG0004056	0	0	0	2	2
OG0004057	0	0	0	2	2
OG0004058	0	0	0	2	2
OG0004059	0	0	0	2	2
OG0004060	0	0	0	2	2
OG0004061	0	0	0	2	2
OG0004062	0	0	0	2	2
OG0004063	0	0	0	2	2
OG0004064	0	0	0	2	2
OG0004065	0	0	0	2	2
OG0004066	0	0	0	2	2
OG0004067	0	0	0	2	2
OG0004068	0	0	0	2	2
OG0004069	0	0	0	2	2
OG0004070	0	0	0	2	2
OG0004071	0	0	0	2	2
OG0004072	0	0	0	2	2
OG0004073	0	0	0	2	2
OG0004074	0	0	0	2	2
OG0004075	0	0	0	2	2
OG0004076	0	0	0	2	2
OG0004077	0	0	0	2	2
OG0004078	0	0	0	2	2
OG0004079	0	0	0	2	2
OG0004080	0	0	0	2	2
OG0004081	0	0	0	2	2
OG0004082	0	0	0	2	2
OG0004083	0	0	0	2	2
OG0004084	0	0	0	2	2
OG0004085	0	0	0	2	2
OG0004086	0	0	0	2	2
OG0004087	0	0	0	2	2
OG0004088	0	0	0	2	2
OG0004089	0	0	0	2	2
OG0004090	0	0	0	2	2
OG0004091	0	0	0	2	2
OG0004092	0	0	0	2	2
OG0004093	0	0	0	2	2
OG0004094	0	0	0	2	2
OG0004095	0	0	0	2	2
OG0004096	0	0	0	2	2
OG0004097	0	0	0	2	2
OG0004098	0	0	0	2	2
OG0004099	0	0	0	2	2
OG0004100	0	0	0	2	2
OG0004101	0	0	0	2	2
OG0004102	0	0	0	2	2
OG0004103	0	0	0	2	2
OG0004104	0	0	0	2	2
OG0004105	0	0	0	2	2
OG0004106	0	0	0	2	2
OG0004107	0	0	0	2	2
OG0004108	0	0	0	2	2
OG0004109	0	0	0	2	2
OG0004110	0	0	0	2	2
OG0004111	0	0	0	2	2
OG0004112	0	0	0	2	2
OG0004113	0	0	0	2	2
OG0004114	0	0	0	2	2
OG0004115	0	0	0	2	2
OG0004116	0	0	0	2	2
OG0004117	0	0	0	2	2
OG0004118	0	0	0	2	2
OG0004119	0	0	0	2	2
OG0004120	0	0	0	2	2
OG0004121	0	0	0	2	2
OG0004122	0	0	0	2	2
OG0004123	0	0	0	2	2
OG0004124	0	0	0	2	2
OG0004125	0	0	0	2	2
OG0004126	0	0	0	2	2
OG0004127	0	0	0	2	2
OG0004128	0	0	0	2	2
OG0004129	0	0	0	2	2
OG0004130	0	0	0	2	2
OG0004131	0	0	0	2	2
OG0004132	0	0	0	2	2
OG0004133	0	0	0	2	2
OG0004134	0	0	0	2	2
OG0004135	0	0	0	2	2
OG0004136	0	0	0	2	2
OG0004137	0	0	0	2	2
OG0004138	0	0	0	2	2
OG0004139	0	0	0	2	2
OG0004140	0	0	0	2	2
OG0004141	0	0	0	2	2
OG0004142	0	0	0	2	2
OG0004143	0	0	0	2	2
OG0004144	0	0	0	2	2
OG0004145	0	0	0	2	2
OG0004146	0	0	0	2	2
OG0004147	0	0	0	2	2
OG0004148	0	0	0	2	2
OG0004149	0	0	0	2	2
OG0004150	0	0	0	2	2
OG0004151	0	0	0	2	2
OG0004152	0	0	0	2	2
OG0004153	0	0	0	2	2
