Orthogroup	protein_mansoni	sequence_Caenorhabditis elegans	sequence_Drosophila melanogaster	sequence_Saccharomyces cerevisiae	Total
OG0000000	111	0	0	0	111
OG0000001	34	0	5	14	53
OG0000002	49	1	1	1	52
OG0000003	52	0	0	0	52
OG0000004	32	5	1	4	42
OG0000005	42	0	0	0	42
OG0000006	19	1	4	15	39
OG0000007	32	0	0	0	32
OG0000008	29	0	0	0	29
OG0000009	28	0	0	0	28
OG0000010	20	1	3	2	26
OG0000011	18	2	2	2	24
OG0000012	16	1	5	1	23
OG0000013	23	0	0	0	23
OG0000014	22	0	0	0	22
OG0000015	22	0	0	0	22
OG0000016	22	0	0	0	22
OG0000017	22	0	0	0	22
OG0000018	21	0	0	0	21
OG0000019	21	0	0	0	21
OG0000020	21	0	0	0	21
OG0000021	20	0	0	0	20
OG0000022	16	1	1	2	20
OG0000023	20	0	0	0	20
OG0000024	19	0	0	0	19
OG0000025	19	0	0	0	19
OG0000026	19	0	0	0	19
OG0000027	18	0	0	0	18
OG0000028	17	1	0	0	18
OG0000029	17	0	0	0	17
OG0000030	8	2	1	6	17
OG0000031	16	0	0	0	16
OG0000032	8	0	8	0	16
OG0000033	16	0	0	0	16
OG0000034	14	0	1	1	16
OG0000035	16	0	0	0	16
OG0000036	16	0	0	0	16
OG0000037	13	0	1	1	15
OG0000038	15	0	0	0	15
OG0000039	8	1	0	6	15
OG0000040	15	0	0	0	15
OG0000041	14	0	0	0	14
OG0000042	14	0	0	0	14
OG0000043	14	0	0	0	14
OG0000044	14	0	0	0	14
OG0000045	12	0	0	1	13
OG0000046	12	0	0	1	13
OG0000047	13	0	0	0	13
OG0000048	13	0	0	0	13
OG0000049	10	2	1	0	13
OG0000050	13	0	0	0	13
OG0000051	13	0	0	0	13
OG0000052	12	0	0	0	12
OG0000053	6	0	6	0	12
OG0000054	12	0	0	0	12
OG0000055	12	0	0	0	12
OG0000056	10	0	1	1	12
OG0000057	12	0	0	0	12
OG0000058	12	0	0	0	12
OG0000059	12	0	0	0	12
OG0000060	12	0	0	0	12
OG0000061	12	0	0	0	12
OG0000062	12	0	0	0	12
OG0000063	12	0	0	0	12
OG0000064	8	1	3	0	12
OG0000065	8	2	0	1	11
OG0000066	9	1	0	1	11
OG0000067	11	0	0	0	11
OG0000068	8	1	1	1	11
OG0000069	7	4	0	0	11
OG0000070	11	0	0	0	11
OG0000071	11	0	0	0	11
OG0000072	10	0	1	0	11
OG0000073	3	0	4	4	11
OG0000074	11	0	0	0	11
OG0000075	11	0	0	0	11
OG0000076	11	0	0	0	11
OG0000077	11	0	0	0	11
OG0000078	6	2	2	1	11
OG0000079	11	0	0	0	11
OG0000080	10	0	1	0	11
OG0000081	11	0	0	0	11
OG0000082	11	0	0	0	11
OG0000083	10	0	0	0	10
OG0000084	10	0	0	0	10
OG0000085	10	0	0	0	10
OG0000086	10	0	0	0	10
OG0000087	6	0	0	4	10
OG0000088	10	0	0	0	10
OG0000089	4	0	4	2	10
OG0000090	10	0	0	0	10
OG0000091	10	0	0	0	10
OG0000092	10	0	0	0	10
OG0000093	10	0	0	0	10
OG0000094	10	0	0	0	10
OG0000095	9	0	0	0	9
OG0000096	9	0	0	0	9
OG0000097	7	0	1	1	9
OG0000098	9	0	0	0	9
OG0000099	7	0	0	2	9
OG0000100	9	0	0	0	9
OG0000101	9	0	0	0	9
OG0000102	9	0	0	0	9
OG0000103	3	2	1	3	9
OG0000104	4	2	0	3	9
OG0000105	5	0	2	2	9
OG0000106	9	0	0	0	9
OG0000107	8	0	1	0	9
OG0000108	9	0	0	0	9
OG0000109	9	0	0	0	9
OG0000110	9	0	0	0	9
OG0000111	9	0	0	0	9
OG0000112	6	0	1	1	8
OG0000113	8	0	0	0	8
OG0000114	8	0	0	0	8
OG0000115	5	0	2	1	8
OG0000116	8	0	0	0	8
OG0000117	8	0	0	0	8
OG0000118	7	0	0	1	8
OG0000119	8	0	0	0	8
OG0000120	8	0	0	0	8
OG0000121	6	1	0	1	8
OG0000122	8	0	0	0	8
OG0000123	8	0	0	0	8
OG0000124	8	0	0	0	8
OG0000125	2	0	6	0	8
OG0000126	6	1	0	0	7
OG0000127	6	1	0	0	7
OG0000128	7	0	0	0	7
OG0000129	7	0	0	0	7
OG0000130	7	0	0	0	7
OG0000131	3	0	1	3	7
OG0000132	7	0	0	0	7
OG0000133	7	0	0	0	7
OG0000134	3	1	0	3	7
OG0000135	7	0	0	0	7
OG0000136	2	2	1	2	7
OG0000137	7	0	0	0	7
OG0000138	7	0	0	0	7
OG0000139	5	0	2	0	7
OG0000140	6	0	0	1	7
OG0000141	7	0	0	0	7
OG0000142	6	0	1	0	7
OG0000143	7	0	0	0	7
OG0000144	7	0	0	0	7
OG0000145	7	0	0	0	7
OG0000146	5	1	0	1	7
OG0000147	7	0	0	0	7
OG0000148	6	0	1	0	7
OG0000149	7	0	0	0	7
OG0000150	7	0	0	0	7
OG0000151	7	0	0	0	7
OG0000152	7	0	0	0	7
OG0000153	7	0	0	0	7
OG0000154	7	0	0	0	7
OG0000155	7	0	0	0	7
OG0000156	4	0	0	3	7
OG0000157	6	0	0	0	6
OG0000158	6	0	0	0	6
OG0000159	6	0	0	0	6
OG0000160	6	0	0	0	6
OG0000161	6	0	0	0	6
OG0000162	6	0	0	0	6
OG0000163	6	0	0	0	6
OG0000164	6	0	0	0	6
OG0000165	5	1	0	0	6
OG0000166	5	1	0	0	6
OG0000167	6	0	0	0	6
OG0000168	6	0	0	0	6
OG0000169	3	1	1	1	6
OG0000170	6	0	0	0	6
OG0000171	6	0	0	0	6
OG0000172	6	0	0	0	6
OG0000173	6	0	0	0	6
OG0000174	6	0	0	0	6
OG0000175	2	2	1	1	6
OG0000176	6	0	0	0	6
OG0000177	3	0	2	1	6
OG0000178	4	0	1	1	6
OG0000179	6	0	0	0	6
OG0000180	3	0	2	1	6
OG0000181	1	2	1	2	6
OG0000182	6	0	0	0	6
OG0000183	6	0	0	0	6
OG0000184	6	0	0	0	6
OG0000185	4	1	1	0	6
OG0000186	6	0	0	0	6
OG0000187	6	0	0	0	6
OG0000188	6	0	0	0	6
OG0000189	6	0	0	0	6
OG0000190	6	0	0	0	6
OG0000191	6	0	0	0	6
OG0000192	6	0	0	0	6
OG0000193	2	1	1	2	6
OG0000194	6	0	0	0	6
OG0000195	6	0	0	0	6
OG0000196	6	0	0	0	6
OG0000197	6	0	0	0	6
OG0000198	3	1	0	2	6
OG0000199	6	0	0	0	6
OG0000200	5	0	0	0	5
OG0000201	5	0	0	0	5
OG0000202	5	0	0	0	5
OG0000203	5	0	0	0	5
OG0000204	4	0	1	0	5
OG0000205	5	0	0	0	5
OG0000206	3	0	0	2	5
OG0000207	4	0	1	0	5
OG0000208	5	0	0	0	5
OG0000209	3	0	1	1	5
OG0000210	4	1	0	0	5
OG0000211	5	0	0	0	5
OG0000212	5	0	0	0	5
OG0000213	5	0	0	0	5
OG0000214	5	0	0	0	5
OG0000215	2	1	1	1	5
OG0000216	4	1	0	0	5
OG0000217	5	0	0	0	5
OG0000218	5	0	0	0	5
OG0000219	5	0	0	0	5
OG0000220	5	0	0	0	5
OG0000221	5	0	0	0	5
OG0000222	5	0	0	0	5
OG0000223	5	0	0	0	5
OG0000224	5	0	0	0	5
OG0000225	5	0	0	0	5
OG0000226	5	0	0	0	5
OG0000227	5	0	0	0	5
OG0000228	5	0	0	0	5
OG0000229	5	0	0	0	5
OG0000230	5	0	0	0	5
OG0000231	5	0	0	0	5
OG0000232	5	0	0	0	5
OG0000233	2	0	3	0	5
OG0000234	5	0	0	0	5
OG0000235	3	0	1	1	5
OG0000236	5	0	0	0	5
OG0000237	5	0	0	0	5
OG0000238	4	0	0	1	5
OG0000239	3	0	1	1	5
OG0000240	5	0	0	0	5
OG0000241	5	0	0	0	5
OG0000242	2	0	3	0	5
OG0000243	5	0	0	0	5
OG0000244	5	0	0	0	5
OG0000245	1	0	2	2	5
OG0000246	3	0	1	1	5
OG0000247	5	0	0	0	5
OG0000248	4	0	0	1	5
OG0000249	5	0	0	0	5
OG0000250	5	0	0	0	5
OG0000251	5	0	0	0	5
OG0000252	5	0	0	0	5
OG0000253	3	0	0	2	5
OG0000254	5	0	0	0	5
OG0000255	5	0	0	0	5
OG0000256	4	0	0	1	5
OG0000257	2	0	3	0	5
OG0000258	5	0	0	0	5
OG0000259	5	0	0	0	5
OG0000260	3	0	2	0	5
OG0000261	5	0	0	0	5
OG0000262	2	0	1	2	5
OG0000263	5	0	0	0	5
OG0000264	5	0	0	0	5
OG0000265	0	0	5	0	5
OG0000266	4	0	0	0	4
OG0000267	4	0	0	0	4
OG0000268	4	0	0	0	4
OG0000269	4	0	0	0	4
OG0000270	4	0	0	0	4
OG0000271	1	1	1	1	4
OG0000272	4	0	0	0	4
OG0000273	4	0	0	0	4
OG0000274	4	0	0	0	4
OG0000275	1	1	1	1	4
OG0000276	3	1	0	0	4
OG0000277	2	1	0	1	4
OG0000278	4	0	0	0	4
OG0000279	4	0	0	0	4
OG0000280	4	0	0	0	4
OG0000281	2	0	2	0	4
OG0000282	4	0	0	0	4
OG0000283	2	0	0	2	4
OG0000284	4	0	0	0	4
OG0000285	4	0	0	0	4
OG0000286	1	1	1	1	4
OG0000287	4	0	0	0	4
OG0000288	2	1	0	1	4
OG0000289	2	1	0	1	4
OG0000290	4	0	0	0	4
OG0000291	2	0	1	1	4
OG0000292	4	0	0	0	4
OG0000293	4	0	0	0	4
OG0000294	2	0	0	2	4
OG0000295	3	0	0	1	4
OG0000296	4	0	0	0	4
OG0000297	4	0	0	0	4
OG0000298	2	0	0	2	4
OG0000299	1	1	1	1	4
OG0000300	4	0	0	0	4
OG0000301	4	0	0	0	4
OG0000302	4	0	0	0	4
OG0000303	2	0	0	2	4
OG0000304	4	0	0	0	4
OG0000305	4	0	0	0	4
OG0000306	1	1	0	2	4
OG0000307	3	0	0	1	4
OG0000308	4	0	0	0	4
OG0000309	3	1	0	0	4
OG0000310	4	0	0	0	4
OG0000311	3	0	0	1	4
OG0000312	2	0	1	1	4
OG0000313	4	0	0	0	4
OG0000314	4	0	0	0	4
OG0000315	4	0	0	0	4
OG0000316	4	0	0	0	4
OG0000317	4	0	0	0	4
OG0000318	4	0	0	0	4
OG0000319	4	0	0	0	4
OG0000320	4	0	0	0	4
OG0000321	4	0	0	0	4
OG0000322	2	0	1	1	4
OG0000323	4	0	0	0	4
OG0000324	2	0	2	0	4
OG0000325	4	0	0	0	4
OG0000326	4	0	0	0	4
OG0000327	4	0	0	0	4
OG0000328	3	0	0	1	4
OG0000329	4	0	0	0	4
OG0000330	4	0	0	0	4
OG0000331	3	0	0	1	4
OG0000332	2	0	0	2	4
OG0000333	3	1	0	0	4
OG0000334	1	1	1	1	4
OG0000335	1	1	1	1	4
OG0000336	2	2	0	0	4
OG0000337	4	0	0	0	4
OG0000338	3	0	0	1	4
OG0000339	4	0	0	0	4
OG0000340	4	0	0	0	4
OG0000341	4	0	0	0	4
OG0000342	2	1	1	0	4
OG0000343	3	0	0	1	4
OG0000344	4	0	0	0	4
OG0000345	1	1	1	1	4
OG0000346	4	0	0	0	4
OG0000347	2	1	0	1	4
OG0000348	4	0	0	0	4
OG0000349	4	0	0	0	4
OG0000350	4	0	0	0	4
OG0000351	4	0	0	0	4
OG0000352	4	0	0	0	4
OG0000353	4	0	0	0	4
OG0000354	2	0	0	2	4
OG0000355	4	0	0	0	4
OG0000356	4	0	0	0	4
OG0000357	4	0	0	0	4
OG0000358	4	0	0	0	4
OG0000359	4	0	0	0	4
OG0000360	4	0	0	0	4
OG0000361	4	0	0	0	4
OG0000362	4	0	0	0	4
OG0000363	4	0	0	0	4
OG0000364	4	0	0	0	4
OG0000365	4	0	0	0	4
OG0000366	3	0	1	0	4
OG0000367	4	0	0	0	4
OG0000368	3	0	0	1	4
OG0000369	2	0	0	2	4
OG0000370	2	0	1	1	4
OG0000371	2	0	0	2	4
OG0000372	4	0	0	0	4
OG0000373	4	0	0	0	4
OG0000374	4	0	0	0	4
OG0000375	4	0	0	0	4
OG0000376	4	0	0	0	4
OG0000377	4	0	0	0	4
OG0000378	1	1	0	2	4
OG0000379	4	0	0	0	4
OG0000380	4	0	0	0	4
OG0000381	4	0	0	0	4
OG0000382	3	0	1	0	4
OG0000383	4	0	0	0	4
OG0000384	1	1	1	1	4
OG0000385	4	0	0	0	4
OG0000386	1	1	1	1	4
OG0000387	4	0	0	0	4
OG0000388	4	0	0	0	4
OG0000389	4	0	0	0	4
OG0000390	4	0	0	0	4
OG0000391	1	1	1	1	4
OG0000392	2	0	0	1	3
OG0000393	3	0	0	0	3
OG0000394	3	0	0	0	3
OG0000395	3	0	0	0	3
OG0000396	2	1	0	0	3
OG0000397	3	0	0	0	3
OG0000398	2	0	0	1	3
OG0000399	1	0	1	1	3
OG0000400	2	0	0	1	3
OG0000401	3	0	0	0	3
OG0000402	1	1	0	1	3
OG0000403	3	0	0	0	3
OG0000404	1	1	1	0	3
OG0000405	3	0	0	0	3
OG0000406	3	0	0	0	3
OG0000407	2	0	0	1	3
OG0000408	3	0	0	0	3
OG0000409	3	0	0	0	3
OG0000410	3	0	0	0	3
OG0000411	3	0	0	0	3
OG0000412	1	1	0	1	3
OG0000413	3	0	0	0	3
OG0000414	1	0	1	1	3
OG0000415	2	0	0	1	3
OG0000416	3	0	0	0	3
OG0000417	3	0	0	0	3
OG0000418	3	0	0	0	3
OG0000419	1	1	0	1	3
OG0000420	1	1	0	1	3
OG0000421	3	0	0	0	3
OG0000422	2	0	1	0	3
OG0000423	1	1	1	0	3
OG0000424	3	0	0	0	3
OG0000425	3	0	0	0	3
OG0000426	1	0	1	1	3
OG0000427	2	0	0	1	3
OG0000428	2	0	0	1	3
OG0000429	3	0	0	0	3
OG0000430	3	0	0	0	3
OG0000431	2	0	0	1	3
OG0000432	3	0	0	0	3
OG0000433	3	0	0	0	3
OG0000434	3	0	0	0	3
OG0000435	1	0	2	0	3
OG0000436	3	0	0	0	3
OG0000437	1	0	1	1	3
OG0000438	3	0	0	0	3
OG0000439	1	0	1	1	3
OG0000440	3	0	0	0	3
OG0000441	1	1	0	1	3
OG0000442	3	0	0	0	3
OG0000443	2	0	0	1	3
OG0000444	3	0	0	0	3
OG0000445	3	0	0	0	3
OG0000446	3	0	0	0	3
OG0000447	1	0	0	2	3
OG0000448	3	0	0	0	3
OG0000449	1	1	0	1	3
OG0000450	1	0	1	1	3
OG0000451	1	1	0	1	3
OG0000452	3	0	0	0	3
OG0000453	3	0	0	0	3
OG0000454	3	0	0	0	3
OG0000455	3	0	0	0	3
OG0000456	1	1	0	1	3
OG0000457	3	0	0	0	3
OG0000458	1	1	0	1	3
OG0000459	1	1	0	1	3
OG0000460	2	1	0	0	3
OG0000461	3	0	0	0	3
OG0000462	1	0	1	1	3
OG0000463	2	0	0	1	3
OG0000464	3	0	0	0	3
OG0000465	3	0	0	0	3
OG0000466	3	0	0	0	3
OG0000467	2	0	0	1	3
OG0000468	1	0	0	2	3
OG0000469	2	0	0	1	3
OG0000470	1	1	0	1	3
OG0000471	3	0	0	0	3
OG0000472	1	0	1	1	3
OG0000473	3	0	0	0	3
OG0000474	1	2	0	0	3
OG0000475	3	0	0	0	3
OG0000476	3	0	0	0	3
OG0000477	3	0	0	0	3
OG0000478	3	0	0	0	3
OG0000479	1	0	1	1	3
OG0000480	1	1	0	1	3
OG0000481	3	0	0	0	3
OG0000482	1	0	1	1	3
OG0000483	3	0	0	0	3
OG0000484	3	0	0	0	3
OG0000485	1	0	2	0	3
OG0000486	2	1	0	0	3
OG0000487	3	0	0	0	3
OG0000488	3	0	0	0	3
OG0000489	3	0	0	0	3
OG0000490	1	1	0	1	3
OG0000491	1	1	0	1	3
OG0000492	1	0	1	1	3
OG0000493	1	1	0	1	3
OG0000494	1	1	0	1	3
OG0000495	3	0	0	0	3
OG0000496	3	0	0	0	3
OG0000497	1	0	0	2	3
OG0000498	2	1	0	0	3
OG0000499	1	1	0	1	3
OG0000500	1	1	0	1	3
OG0000501	3	0	0	0	3
OG0000502	1	0	1	1	3
OG0000503	1	1	0	1	3
OG0000504	2	0	1	0	3
OG0000505	1	0	1	1	3
OG0000506	1	1	0	1	3
OG0000507	1	0	1	1	3
OG0000508	3	0	0	0	3
OG0000509	2	0	0	1	3
OG0000510	3	0	0	0	3
OG0000511	3	0	0	0	3
OG0000512	2	0	0	1	3
OG0000513	1	1	0	1	3
OG0000514	3	0	0	0	3
OG0000515	3	0	0	0	3
OG0000516	2	0	1	0	3
OG0000517	3	0	0	0	3
OG0000518	2	0	1	0	3
OG0000519	3	0	0	0	3
OG0000520	1	1	0	1	3
OG0000521	3	0	0	0	3
OG0000522	2	0	0	1	3
OG0000523	3	0	0	0	3
OG0000524	1	0	1	1	3
OG0000525	2	0	0	1	3
OG0000526	3	0	0	0	3
OG0000527	1	0	1	1	3
OG0000528	3	0	0	0	3
OG0000529	3	0	0	0	3
OG0000530	1	1	1	0	3
OG0000531	1	1	0	1	3
OG0000532	3	0	0	0	3
OG0000533	1	0	1	1	3
OG0000534	3	0	0	0	3
OG0000535	2	0	0	1	3
OG0000536	1	0	1	1	3
OG0000537	3	0	0	0	3
OG0000538	3	0	0	0	3
OG0000539	3	0	0	0	3
OG0000540	2	0	0	1	3
OG0000541	1	1	0	1	3
OG0000542	3	0	0	0	3
OG0000543	3	0	0	0	3
OG0000544	1	1	0	1	3
OG0000545	3	0	0	0	3
OG0000546	3	0	0	0	3
OG0000547	3	0	0	0	3
OG0000548	1	0	1	1	3
OG0000549	3	0	0	0	3
OG0000550	3	0	0	0	3
OG0000551	1	0	1	1	3
OG0000552	3	0	0	0	3
OG0000553	3	0	0	0	3
OG0000554	3	0	0	0	3
OG0000555	2	0	0	1	3
OG0000556	3	0	0	0	3
OG0000557	3	0	0	0	3
OG0000558	1	1	0	1	3
OG0000559	2	0	0	1	3
OG0000560	3	0	0	0	3
OG0000561	3	0	0	0	3
OG0000562	3	0	0	0	3
OG0000563	3	0	0	0	3
OG0000564	1	1	0	1	3
OG0000565	3	0	0	0	3
OG0000566	2	0	0	1	3
OG0000567	3	0	0	0	3
OG0000568	2	0	0	1	3
OG0000569	1	1	0	1	3
OG0000570	3	0	0	0	3
OG0000571	1	0	1	1	3
OG0000572	2	0	0	1	3
OG0000573	3	0	0	0	3
OG0000574	3	0	0	0	3
OG0000575	3	0	0	0	3
OG0000576	3	0	0	0	3
OG0000577	2	0	1	0	3
OG0000578	1	0	1	1	3
OG0000579	2	0	1	0	3
OG0000580	2	0	0	1	3
OG0000581	1	1	0	1	3
OG0000582	1	0	0	2	3
OG0000583	3	0	0	0	3
OG0000584	2	0	0	1	3
OG0000585	3	0	0	0	3
OG0000586	1	1	0	1	3
OG0000587	3	0	0	0	3
OG0000588	1	1	0	1	3
OG0000589	3	0	0	0	3
OG0000590	2	0	0	1	3
OG0000591	1	0	1	1	3
OG0000592	1	0	1	1	3
OG0000593	1	0	1	1	3
OG0000594	3	0	0	0	3
OG0000595	3	0	0	0	3
OG0000596	1	1	0	1	3
OG0000597	1	1	0	1	3
OG0000598	1	0	1	1	3
OG0000599	1	1	0	1	3
OG0000600	3	0	0	0	3
OG0000601	1	1	0	1	3
OG0000602	3	0	0	0	3
OG0000603	3	0	0	0	3
OG0000604	3	0	0	0	3
OG0000605	3	0	0	0	3
OG0000606	1	1	0	1	3
OG0000607	2	0	0	1	3
OG0000608	1	1	0	1	3
OG0000609	3	0	0	0	3
OG0000610	2	1	0	0	3
OG0000611	3	0	0	0	3
OG0000612	3	0	0	0	3
OG0000613	3	0	0	0	3
OG0000614	3	0	0	0	3
OG0000615	3	0	0	0	3
OG0000616	1	0	1	1	3
OG0000617	3	0	0	0	3
OG0000618	1	0	1	1	3
OG0000619	1	0	1	1	3
OG0000620	1	1	0	1	3
OG0000621	1	0	1	1	3
OG0000622	2	0	0	1	3
OG0000623	1	1	0	1	3
OG0000624	3	0	0	0	3
OG0000625	3	0	0	0	3
OG0000626	2	1	0	0	3
OG0000627	1	1	1	0	3
OG0000628	2	1	0	0	3
OG0000629	1	1	0	1	3
OG0000630	1	1	0	1	3
OG0000631	3	0	0	0	3
OG0000632	1	0	1	1	3
OG0000633	3	0	0	0	3
OG0000634	3	0	0	0	3
OG0000635	1	0	2	0	3
OG0000636	1	1	0	1	3
OG0000637	3	0	0	0	3
OG0000638	1	0	0	2	3
OG0000639	3	0	0	0	3
OG0000640	1	1	1	0	3
OG0000641	3	0	0	0	3
OG0000642	3	0	0	0	3
OG0000643	1	1	0	1	3
OG0000644	3	0	0	0	3
OG0000645	1	0	1	1	3
OG0000646	2	0	0	1	3
OG0000647	1	1	0	1	3
OG0000648	3	0	0	0	3
OG0000649	3	0	0	0	3
OG0000650	1	1	0	1	3
OG0000651	3	0	0	0	3
OG0000652	1	1	0	1	3
OG0000653	3	0	0	0	3
OG0000654	3	0	0	0	3
OG0000655	1	1	0	1	3
OG0000656	3	0	0	0	3
OG0000657	3	0	0	0	3
OG0000658	1	0	1	1	3
OG0000659	3	0	0	0	3
OG0000660	3	0	0	0	3
OG0000661	1	1	0	1	3
OG0000662	3	0	0	0	3
OG0000663	3	0	0	0	3
OG0000664	3	0	0	0	3
OG0000665	3	0	0	0	3
OG0000666	2	1	0	0	3
OG0000667	3	0	0	0	3
OG0000668	3	0	0	0	3
OG0000669	3	0	0	0	3
OG0000670	1	1	1	0	3
OG0000671	3	0	0	0	3
OG0000672	3	0	0	0	3
OG0000673	2	0	0	1	3
OG0000674	1	0	0	2	3
OG0000675	3	0	0	0	3
OG0000676	3	0	0	0	3
OG0000677	3	0	0	0	3
OG0000678	2	0	0	1	3
OG0000679	3	0	0	0	3
OG0000680	1	1	0	1	3
OG0000681	3	0	0	0	3
OG0000682	3	0	0	0	3
OG0000683	3	0	0	0	3
OG0000684	3	0	0	0	3
OG0000685	2	0	1	0	3
OG0000686	3	0	0	0	3
OG0000687	3	0	0	0	3
OG0000688	1	0	1	1	3
OG0000689	1	1	0	1	3
OG0000690	2	1	0	0	3
OG0000691	3	0	0	0	3
OG0000692	1	1	0	1	3
OG0000693	3	0	0	0	3
OG0000694	1	0	2	0	3
OG0000695	3	0	0	0	3
OG0000696	1	0	1	1	3
OG0000697	3	0	0	0	3
OG0000698	3	0	0	0	3
OG0000699	1	0	1	1	3
OG0000700	1	1	0	1	3
OG0000701	1	0	1	1	3
OG0000702	2	0	1	0	3
OG0000703	3	0	0	0	3
OG0000704	2	0	0	1	3
OG0000705	1	1	0	1	3
OG0000706	1	1	0	1	3
OG0000707	2	0	1	0	3
OG0000708	1	0	2	0	3
OG0000709	3	0	0	0	3
OG0000710	2	1	0	0	3
OG0000711	2	0	1	0	3
OG0000712	1	1	0	1	3
OG0000713	1	0	1	1	3
OG0000714	1	1	0	1	3
OG0000715	1	1	0	1	3
OG0000716	1	1	0	1	3
OG0000717	3	0	0	0	3
OG0000718	1	1	0	1	3
OG0000719	1	1	0	1	3
OG0000720	1	1	1	0	3
OG0000721	1	0	1	1	3
OG0000722	3	0	0	0	3
OG0000723	3	0	0	0	3
OG0000724	3	0	0	0	3
OG0000725	1	0	0	2	3
OG0000726	1	0	1	1	3
OG0000727	0	3	0	0	3
OG0000728	0	0	0	3	3
OG0000729	2	0	0	0	2
OG0000730	2	0	0	0	2
OG0000731	1	0	0	1	2
OG0000732	2	0	0	0	2
OG0000733	2	0	0	0	2
OG0000734	2	0	0	0	2
OG0000735	2	0	0	0	2
OG0000736	2	0	0	0	2
OG0000737	1	0	0	1	2
OG0000738	2	0	0	0	2
OG0000739	1	0	0	1	2
OG0000740	2	0	0	0	2
OG0000741	2	0	0	0	2
OG0000742	2	0	0	0	2
OG0000743	1	0	0	1	2
OG0000744	1	0	1	0	2
OG0000745	1	0	0	1	2
OG0000746	1	0	1	0	2
OG0000747	1	0	0	1	2
OG0000748	2	0	0	0	2
OG0000749	2	0	0	0	2
OG0000750	2	0	0	0	2
OG0000751	2	0	0	0	2
OG0000752	1	0	0	1	2
OG0000753	1	0	0	1	2
OG0000754	2	0	0	0	2
OG0000755	1	0	0	1	2
OG0000756	2	0	0	0	2
OG0000757	1	0	0	1	2
OG0000758	2	0	0	0	2
OG0000759	2	0	0	0	2
OG0000760	1	0	0	1	2
OG0000761	1	0	0	1	2
OG0000762	2	0	0	0	2
OG0000763	1	0	0	1	2
OG0000764	1	0	0	1	2
OG0000765	1	0	1	0	2
OG0000766	2	0	0	0	2
OG0000767	1	0	0	1	2
OG0000768	2	0	0	0	2
OG0000769	2	0	0	0	2
OG0000770	1	0	0	1	2
OG0000771	2	0	0	0	2
OG0000772	1	0	0	1	2
OG0000773	2	0	0	0	2
OG0000774	2	0	0	0	2
OG0000775	1	1	0	0	2
OG0000776	2	0	0	0	2
OG0000777	2	0	0	0	2
OG0000778	2	0	0	0	2
OG0000779	1	0	0	1	2
OG0000780	1	0	0	1	2
OG0000781	2	0	0	0	2
OG0000782	2	0	0	0	2
OG0000783	2	0	0	0	2
OG0000784	1	0	0	1	2
OG0000785	2	0	0	0	2
OG0000786	2	0	0	0	2
OG0000787	1	0	0	1	2
OG0000788	1	0	0	1	2
OG0000789	2	0	0	0	2
OG0000790	2	0	0	0	2
OG0000791	2	0	0	0	2
OG0000792	2	0	0	0	2
OG0000793	1	0	0	1	2
OG0000794	2	0	0	0	2
OG0000795	1	0	1	0	2
OG0000796	2	0	0	0	2
OG0000797	2	0	0	0	2
OG0000798	2	0	0	0	2
OG0000799	2	0	0	0	2
OG0000800	2	0	0	0	2
OG0000801	2	0	0	0	2
OG0000802	2	0	0	0	2
OG0000803	2	0	0	0	2
OG0000804	1	0	0	1	2
OG0000805	1	0	0	1	2
OG0000806	1	0	0	1	2
OG0000807	1	0	0	1	2
OG0000808	1	0	0	1	2
OG0000809	1	0	0	1	2
OG0000810	1	0	0	1	2
OG0000811	2	0	0	0	2
OG0000812	1	0	0	1	2
OG0000813	1	0	0	1	2
OG0000814	2	0	0	0	2
OG0000815	2	0	0	0	2
OG0000816	1	0	1	0	2
OG0000817	2	0	0	0	2
OG0000818	2	0	0	0	2
OG0000819	1	0	0	1	2
OG0000820	2	0	0	0	2
OG0000821	2	0	0	0	2
OG0000822	2	0	0	0	2
OG0000823	1	0	1	0	2
OG0000824	2	0	0	0	2
OG0000825	1	0	0	1	2
OG0000826	2	0	0	0	2
OG0000827	1	0	0	1	2
OG0000828	1	0	0	1	2
OG0000829	2	0	0	0	2
OG0000830	2	0	0	0	2
OG0000831	2	0	0	0	2
OG0000832	1	0	0	1	2
OG0000833	2	0	0	0	2
OG0000834	2	0	0	0	2
OG0000835	1	0	0	1	2
OG0000836	2	0	0	0	2
OG0000837	2	0	0	0	2
OG0000838	2	0	0	0	2
OG0000839	1	1	0	0	2
OG0000840	1	0	0	1	2
OG0000841	1	0	0	1	2
OG0000842	2	0	0	0	2
OG0000843	1	0	0	1	2
OG0000844	1	0	0	1	2
OG0000845	1	0	0	1	2
OG0000846	2	0	0	0	2
OG0000847	2	0	0	0	2
OG0000848	1	0	0	1	2
OG0000849	1	0	0	1	2
OG0000850	2	0	0	0	2
OG0000851	2	0	0	0	2
OG0000852	2	0	0	0	2
OG0000853	2	0	0	0	2
OG0000854	2	0	0	0	2
OG0000855	1	0	0	1	2
OG0000856	2	0	0	0	2
OG0000857	1	0	1	0	2
OG0000858	1	0	0	1	2
OG0000859	1	0	0	1	2
OG0000860	2	0	0	0	2
OG0000861	2	0	0	0	2
OG0000862	2	0	0	0	2
OG0000863	1	1	0	0	2
OG0000864	2	0	0	0	2
OG0000865	2	0	0	0	2
OG0000866	2	0	0	0	2
OG0000867	1	0	0	1	2
OG0000868	1	1	0	0	2
OG0000869	1	0	0	1	2
OG0000870	2	0	0	0	2
OG0000871	2	0	0	0	2
OG0000872	1	0	0	1	2
OG0000873	2	0	0	0	2
OG0000874	2	0	0	0	2
OG0000875	1	0	1	0	2
OG0000876	2	0	0	0	2
OG0000877	1	0	0	1	2
OG0000878	2	0	0	0	2
OG0000879	1	0	0	1	2
OG0000880	2	0	0	0	2
OG0000881	1	0	0	1	2
OG0000882	2	0	0	0	2
OG0000883	1	0	0	1	2
OG0000884	1	0	0	1	2
OG0000885	2	0	0	0	2
OG0000886	1	0	0	1	2
OG0000887	1	1	0	0	2
OG0000888	1	1	0	0	2
OG0000889	1	0	0	1	2
OG0000890	1	0	1	0	2
OG0000891	1	0	0	1	2
OG0000892	2	0	0	0	2
OG0000893	2	0	0	0	2
OG0000894	1	1	0	0	2
OG0000895	2	0	0	0	2
OG0000896	1	0	0	1	2
OG0000897	1	0	0	1	2
OG0000898	1	0	0	1	2
OG0000899	1	1	0	0	2
OG0000900	2	0	0	0	2
OG0000901	2	0	0	0	2
OG0000902	2	0	0	0	2
OG0000903	1	0	0	1	2
OG0000904	2	0	0	0	2
OG0000905	1	0	0	1	2
OG0000906	1	0	0	1	2
OG0000907	1	0	0	1	2
OG0000908	2	0	0	0	2
OG0000909	2	0	0	0	2
OG0000910	1	0	0	1	2
OG0000911	1	0	1	0	2
OG0000912	2	0	0	0	2
OG0000913	1	1	0	0	2
OG0000914	1	1	0	0	2
OG0000915	2	0	0	0	2
OG0000916	2	0	0	0	2
OG0000917	2	0	0	0	2
OG0000918	1	1	0	0	2
OG0000919	1	0	0	1	2
OG0000920	1	0	0	1	2
OG0000921	2	0	0	0	2
OG0000922	1	1	0	0	2
OG0000923	2	0	0	0	2
OG0000924	1	0	0	1	2
OG0000925	2	0	0	0	2
OG0000926	1	0	0	1	2
OG0000927	1	0	0	1	2
OG0000928	2	0	0	0	2
OG0000929	1	0	1	0	2
OG0000930	2	0	0	0	2
OG0000931	1	1	0	0	2
OG0000932	1	0	0	1	2
OG0000933	1	1	0	0	2
OG0000934	2	0	0	0	2
OG0000935	2	0	0	0	2
OG0000936	2	0	0	0	2
OG0000937	2	0	0	0	2
OG0000938	1	0	0	1	2
OG0000939	2	0	0	0	2
OG0000940	2	0	0	0	2
OG0000941	1	0	0	1	2
OG0000942	2	0	0	0	2
OG0000943	2	0	0	0	2
OG0000944	2	0	0	0	2
OG0000945	1	0	0	1	2
OG0000946	1	0	0	1	2
OG0000947	1	0	0	1	2
OG0000948	1	0	0	1	2
OG0000949	2	0	0	0	2
OG0000950	2	0	0	0	2
OG0000951	1	0	1	0	2
OG0000952	1	1	0	0	2
OG0000953	1	0	0	1	2
OG0000954	1	0	0	1	2
OG0000955	2	0	0	0	2
OG0000956	2	0	0	0	2
OG0000957	1	0	0	1	2
OG0000958	2	0	0	0	2
OG0000959	1	0	0	1	2
OG0000960	1	0	0	1	2
OG0000961	1	0	0	1	2
OG0000962	1	0	0	1	2
OG0000963	1	0	0	1	2
OG0000964	1	1	0	0	2
OG0000965	1	0	0	1	2
OG0000966	2	0	0	0	2
OG0000967	1	0	0	1	2
OG0000968	1	1	0	0	2
OG0000969	1	0	0	1	2
OG0000970	2	0	0	0	2
OG0000971	2	0	0	0	2
OG0000972	1	0	0	1	2
OG0000973	2	0	0	0	2
OG0000974	2	0	0	0	2
OG0000975	1	0	1	0	2
OG0000976	2	0	0	0	2
OG0000977	2	0	0	0	2
OG0000978	2	0	0	0	2
OG0000979	1	0	0	1	2
OG0000980	2	0	0	0	2
OG0000981	1	1	0	0	2
OG0000982	1	0	0	1	2
OG0000983	1	0	0	1	2
OG0000984	1	0	0	1	2
OG0000985	2	0	0	0	2
OG0000986	1	0	0	1	2
OG0000987	2	0	0	0	2
OG0000988	2	0	0	0	2
OG0000989	1	0	0	1	2
OG0000990	2	0	0	0	2
OG0000991	1	1	0	0	2
OG0000992	2	0	0	0	2
OG0000993	1	0	0	1	2
OG0000994	2	0	0	0	2
OG0000995	1	0	0	1	2
OG0000996	1	0	0	1	2
OG0000997	2	0	0	0	2
OG0000998	2	0	0	0	2
OG0000999	1	0	1	0	2
OG0001000	2	0	0	0	2
OG0001001	2	0	0	0	2
OG0001002	1	0	0	1	2
OG0001003	2	0	0	0	2
OG0001004	2	0	0	0	2
OG0001005	2	0	0	0	2
OG0001006	1	0	0	1	2
OG0001007	2	0	0	0	2
OG0001008	1	0	0	1	2
OG0001009	2	0	0	0	2
OG0001010	1	0	0	1	2
OG0001011	1	0	1	0	2
OG0001012	2	0	0	0	2
OG0001013	1	0	0	1	2
OG0001014	1	0	0	1	2
OG0001015	1	0	1	0	2
OG0001016	1	0	0	1	2
OG0001017	2	0	0	0	2
OG0001018	1	0	0	1	2
OG0001019	1	1	0	0	2
OG0001020	1	0	0	1	2
OG0001021	1	0	0	1	2
OG0001022	1	0	1	0	2
OG0001023	2	0	0	0	2
OG0001024	1	0	0	1	2
OG0001025	2	0	0	0	2
OG0001026	1	0	0	1	2
OG0001027	2	0	0	0	2
OG0001028	1	0	0	1	2
OG0001029	2	0	0	0	2
OG0001030	1	0	0	1	2
OG0001031	1	0	0	1	2
OG0001032	2	0	0	0	2
OG0001033	2	0	0	0	2
OG0001034	1	0	0	1	2
OG0001035	1	0	0	1	2
OG0001036	1	1	0	0	2
OG0001037	1	0	0	1	2
OG0001038	1	0	0	1	2
OG0001039	2	0	0	0	2
OG0001040	2	0	0	0	2
OG0001041	1	0	0	1	2
OG0001042	2	0	0	0	2
OG0001043	1	0	0	1	2
OG0001044	1	1	0	0	2
OG0001045	2	0	0	0	2
OG0001046	1	0	0	1	2
OG0001047	2	0	0	0	2
OG0001048	1	1	0	0	2
OG0001049	1	0	0	1	2
OG0001050	1	0	0	1	2
OG0001051	2	0	0	0	2
OG0001052	1	0	0	1	2
OG0001053	2	0	0	0	2
OG0001054	2	0	0	0	2
OG0001055	2	0	0	0	2
OG0001056	1	0	0	1	2
OG0001057	1	0	0	1	2
OG0001058	1	0	0	1	2
OG0001059	2	0	0	0	2
OG0001060	1	0	0	1	2
OG0001061	1	0	0	1	2
OG0001062	1	0	0	1	2
OG0001063	1	0	0	1	2
OG0001064	2	0	0	0	2
OG0001065	1	0	0	1	2
OG0001066	2	0	0	0	2
OG0001067	1	0	0	1	2
OG0001068	1	0	1	0	2
OG0001069	2	0	0	0	2
OG0001070	1	0	1	0	2
OG0001071	1	1	0	0	2
OG0001072	2	0	0	0	2
OG0001073	2	0	0	0	2
OG0001074	1	1	0	0	2
OG0001075	2	0	0	0	2
OG0001076	1	0	0	1	2
OG0001077	2	0	0	0	2
OG0001078	1	0	0	1	2
OG0001079	2	0	0	0	2
OG0001080	1	0	0	1	2
OG0001081	1	0	0	1	2
OG0001082	2	0	0	0	2
OG0001083	2	0	0	0	2
OG0001084	1	0	0	1	2
OG0001085	2	0	0	0	2
OG0001086	2	0	0	0	2
OG0001087	2	0	0	0	2
OG0001088	2	0	0	0	2
OG0001089	1	0	0	1	2
OG0001090	1	0	0	1	2
OG0001091	1	0	0	1	2
OG0001092	2	0	0	0	2
OG0001093	2	0	0	0	2
OG0001094	1	0	1	0	2
OG0001095	2	0	0	0	2
OG0001096	1	1	0	0	2
OG0001097	2	0	0	0	2
OG0001098	2	0	0	0	2
OG0001099	1	0	0	1	2
OG0001100	1	0	0	1	2
OG0001101	1	0	0	1	2
OG0001102	2	0	0	0	2
OG0001103	1	0	0	1	2
OG0001104	1	0	0	1	2
OG0001105	1	0	1	0	2
OG0001106	1	0	0	1	2
OG0001107	2	0	0	0	2
OG0001108	2	0	0	0	2
OG0001109	1	0	1	0	2
OG0001110	1	1	0	0	2
OG0001111	1	0	0	1	2
OG0001112	1	0	1	0	2
OG0001113	2	0	0	0	2
OG0001114	2	0	0	0	2
OG0001115	1	0	0	1	2
OG0001116	1	0	1	0	2
OG0001117	1	0	0	1	2
OG0001118	1	0	0	1	2
OG0001119	1	0	0	1	2
OG0001120	1	0	0	1	2
OG0001121	1	0	0	1	2
OG0001122	2	0	0	0	2
OG0001123	1	0	0	1	2
OG0001124	1	0	0	1	2
OG0001125	1	0	0	1	2
OG0001126	1	0	0	1	2
OG0001127	1	0	0	1	2
OG0001128	2	0	0	0	2
OG0001129	2	0	0	0	2
OG0001130	1	0	0	1	2
OG0001131	1	0	1	0	2
OG0001132	1	0	0	1	2
OG0001133	2	0	0	0	2
OG0001134	1	0	0	1	2
OG0001135	2	0	0	0	2
OG0001136	1	0	0	1	2
OG0001137	1	0	0	1	2
OG0001138	1	0	0	1	2
OG0001139	1	0	0	1	2
OG0001140	2	0	0	0	2
OG0001141	2	0	0	0	2
OG0001142	1	1	0	0	2
OG0001143	1	0	0	1	2
OG0001144	1	0	1	0	2
OG0001145	1	0	0	1	2
OG0001146	1	1	0	0	2
OG0001147	1	0	0	1	2
OG0001148	2	0	0	0	2
OG0001149	1	1	0	0	2
OG0001150	2	0	0	0	2
OG0001151	1	0	0	1	2
OG0001152	1	0	0	1	2
OG0001153	2	0	0	0	2
OG0001154	1	0	0	1	2
OG0001155	1	0	0	1	2
OG0001156	2	0	0	0	2
OG0001157	1	0	1	0	2
OG0001158	1	0	0	1	2
OG0001159	1	0	1	0	2
OG0001160	1	0	0	1	2
OG0001161	2	0	0	0	2
OG0001162	2	0	0	0	2
OG0001163	2	0	0	0	2
OG0001164	1	1	0	0	2
OG0001165	1	0	0	1	2
OG0001166	1	0	0	1	2
OG0001167	1	0	0	1	2
OG0001168	1	0	0	1	2
OG0001169	1	0	0	1	2
OG0001170	2	0	0	0	2
OG0001171	1	0	0	1	2
OG0001172	2	0	0	0	2
OG0001173	2	0	0	0	2
OG0001174	1	0	1	0	2
OG0001175	1	1	0	0	2
OG0001176	2	0	0	0	2
OG0001177	1	1	0	0	2
OG0001178	1	0	0	1	2
OG0001179	1	0	0	1	2
OG0001180	2	0	0	0	2
OG0001181	2	0	0	0	2
OG0001182	1	0	0	1	2
OG0001183	1	0	1	0	2
OG0001184	2	0	0	0	2
OG0001185	2	0	0	0	2
OG0001186	1	0	0	1	2
OG0001187	1	0	0	1	2
OG0001188	2	0	0	0	2
OG0001189	1	0	0	1	2
OG0001190	2	0	0	0	2
OG0001191	2	0	0	0	2
OG0001192	2	0	0	0	2
OG0001193	2	0	0	0	2
OG0001194	2	0	0	0	2
OG0001195	2	0	0	0	2
OG0001196	2	0	0	0	2
OG0001197	1	0	0	1	2
OG0001198	1	0	1	0	2
OG0001199	1	0	0	1	2
OG0001200	1	0	0	1	2
OG0001201	1	0	0	1	2
OG0001202	2	0	0	0	2
OG0001203	2	0	0	0	2
OG0001204	2	0	0	0	2
OG0001205	1	0	0	1	2
OG0001206	2	0	0	0	2
OG0001207	2	0	0	0	2
OG0001208	1	0	0	1	2
OG0001209	1	0	0	1	2
OG0001210	1	0	0	1	2
OG0001211	1	0	0	1	2
OG0001212	2	0	0	0	2
OG0001213	1	0	1	0	2
OG0001214	1	0	0	1	2
OG0001215	1	0	0	1	2
OG0001216	1	0	0	1	2
OG0001217	1	0	0	1	2
OG0001218	1	0	0	1	2
OG0001219	1	0	1	0	2
OG0001220	1	0	0	1	2
OG0001221	2	0	0	0	2
OG0001222	1	0	0	1	2
OG0001223	1	0	1	0	2
OG0001224	1	1	0	0	2
OG0001225	1	0	0	1	2
OG0001226	1	0	1	0	2
OG0001227	1	0	0	1	2
OG0001228	1	0	0	1	2
OG0001229	1	0	0	1	2
OG0001230	2	0	0	0	2
OG0001231	1	0	0	1	2
OG0001232	2	0	0	0	2
OG0001233	2	0	0	0	2
OG0001234	2	0	0	0	2
OG0001235	1	0	0	1	2
OG0001236	1	0	0	1	2
OG0001237	1	0	0	1	2
OG0001238	2	0	0	0	2
OG0001239	1	0	0	1	2
OG0001240	1	1	0	0	2
OG0001241	1	0	1	0	2
OG0001242	1	0	0	1	2
OG0001243	1	1	0	0	2
OG0001244	1	0	1	0	2
OG0001245	1	0	1	0	2
OG0001246	1	0	0	1	2
OG0001247	1	0	0	1	2
OG0001248	2	0	0	0	2
OG0001249	1	0	0	1	2
OG0001250	2	0	0	0	2
OG0001251	2	0	0	0	2
OG0001252	2	0	0	0	2
OG0001253	1	0	0	1	2
OG0001254	1	0	0	1	2
OG0001255	2	0	0	0	2
OG0001256	2	0	0	0	2
OG0001257	1	1	0	0	2
OG0001258	1	0	1	0	2
OG0001259	1	0	0	1	2
OG0001260	2	0	0	0	2
OG0001261	1	1	0	0	2
OG0001262	2	0	0	0	2
OG0001263	1	0	0	1	2
OG0001264	1	0	0	1	2
OG0001265	1	0	0	1	2
OG0001266	2	0	0	0	2
OG0001267	1	0	0	1	2
OG0001268	1	0	0	1	2
OG0001269	1	0	0	1	2
OG0001270	2	0	0	0	2
OG0001271	2	0	0	0	2
OG0001272	2	0	0	0	2
OG0001273	2	0	0	0	2
OG0001274	1	0	0	1	2
OG0001275	2	0	0	0	2
OG0001276	2	0	0	0	2
OG0001277	2	0	0	0	2
OG0001278	2	0	0	0	2
OG0001279	2	0	0	0	2
OG0001280	1	1	0	0	2
OG0001281	2	0	0	0	2
OG0001282	2	0	0	0	2
OG0001283	1	0	0	1	2
OG0001284	1	0	0	1	2
OG0001285	2	0	0	0	2
OG0001286	1	0	0	1	2
OG0001287	1	0	0	1	2
OG0001288	2	0	0	0	2
OG0001289	2	0	0	0	2
OG0001290	1	0	0	1	2
OG0001291	1	1	0	0	2
OG0001292	2	0	0	0	2
OG0001293	1	0	0	1	2
OG0001294	1	1	0	0	2
OG0001295	1	0	0	1	2
OG0001296	1	0	1	0	2
OG0001297	2	0	0	0	2
OG0001298	1	1	0	0	2
OG0001299	1	0	1	0	2
OG0001300	1	0	0	1	2
OG0001301	1	1	0	0	2
OG0001302	2	0	0	0	2
OG0001303	1	0	0	1	2
OG0001304	1	0	0	1	2
OG0001305	1	0	0	1	2
OG0001306	2	0	0	0	2
OG0001307	2	0	0	0	2
OG0001308	1	1	0	0	2
OG0001309	1	0	0	1	2
OG0001310	1	0	0	1	2
OG0001311	1	0	0	1	2
OG0001312	1	1	0	0	2
OG0001313	2	0	0	0	2
OG0001314	2	0	0	0	2
OG0001315	2	0	0	0	2
OG0001316	2	0	0	0	2
OG0001317	2	0	0	0	2
OG0001318	2	0	0	0	2
OG0001319	2	0	0	0	2
OG0001320	2	0	0	0	2
OG0001321	2	0	0	0	2
OG0001322	2	0	0	0	2
OG0001323	2	0	0	0	2
OG0001324	1	0	0	1	2
OG0001325	1	0	0	1	2
OG0001326	1	0	0	1	2
OG0001327	1	0	0	1	2
OG0001328	1	0	0	1	2
OG0001329	1	0	0	1	2
OG0001330	2	0	0	0	2
OG0001331	2	0	0	0	2
OG0001332	2	0	0	0	2
OG0001333	1	0	0	1	2
OG0001334	1	1	0	0	2
OG0001335	1	1	0	0	2
OG0001336	2	0	0	0	2
OG0001337	2	0	0	0	2
OG0001338	1	0	0	1	2
OG0001339	2	0	0	0	2
OG0001340	2	0	0	0	2
OG0001341	2	0	0	0	2
OG0001342	2	0	0	0	2
OG0001343	1	0	0	1	2
OG0001344	2	0	0	0	2
OG0001345	1	0	0	1	2
OG0001346	1	0	0	1	2
OG0001347	2	0	0	0	2
OG0001348	2	0	0	0	2
OG0001349	2	0	0	0	2
OG0001350	2	0	0	0	2
OG0001351	2	0	0	0	2
OG0001352	2	0	0	0	2
OG0001353	1	0	0	1	2
OG0001354	2	0	0	0	2
OG0001355	2	0	0	0	2
OG0001356	1	0	0	1	2
OG0001357	1	0	0	1	2
OG0001358	2	0	0	0	2
OG0001359	2	0	0	0	2
OG0001360	2	0	0	0	2
OG0001361	2	0	0	0	2
OG0001362	2	0	0	0	2
OG0001363	2	0	0	0	2
OG0001364	2	0	0	0	2
OG0001365	2	0	0	0	2
OG0001366	2	0	0	0	2
OG0001367	2	0	0	0	2
OG0001368	2	0	0	0	2
OG0001369	2	0	0	0	2
OG0001370	1	0	1	0	2
OG0001371	2	0	0	0	2
OG0001372	1	1	0	0	2
OG0001373	1	0	0	1	2
OG0001374	1	0	0	1	2
OG0001375	1	1	0	0	2
OG0001376	2	0	0	0	2
OG0001377	2	0	0	0	2
OG0001378	2	0	0	0	2
OG0001379	2	0	0	0	2
OG0001380	1	0	0	1	2
OG0001381	2	0	0	0	2
OG0001382	1	1	0	0	2
OG0001383	2	0	0	0	2
OG0001384	2	0	0	0	2
OG0001385	1	0	0	1	2
OG0001386	2	0	0	0	2
OG0001387	2	0	0	0	2
OG0001388	1	0	0	1	2
OG0001389	1	1	0	0	2
OG0001390	2	0	0	0	2
OG0001391	2	0	0	0	2
OG0001392	2	0	0	0	2
OG0001393	2	0	0	0	2
OG0001394	2	0	0	0	2
OG0001395	1	0	0	1	2
OG0001396	2	0	0	0	2
OG0001397	2	0	0	0	2
OG0001398	1	0	0	1	2
OG0001399	1	0	0	1	2
OG0001400	2	0	0	0	2
OG0001401	2	0	0	0	2
OG0001402	1	0	0	1	2
OG0001403	1	0	1	0	2
OG0001404	1	0	1	0	2
OG0001405	1	0	0	1	2
OG0001406	2	0	0	0	2
OG0001407	1	0	1	0	2
OG0001408	1	0	0	1	2
OG0001409	1	0	0	1	2
OG0001410	1	0	0	1	2
OG0001411	2	0	0	0	2
OG0001412	1	0	0	1	2
OG0001413	2	0	0	0	2
OG0001414	2	0	0	0	2
OG0001415	1	0	0	1	2
OG0001416	1	0	0	1	2
OG0001417	1	0	0	1	2
OG0001418	2	0	0	0	2
OG0001419	1	0	0	1	2
OG0001420	2	0	0	0	2
OG0001421	1	0	0	1	2
OG0001422	1	0	0	1	2
OG0001423	2	0	0	0	2
OG0001424	1	0	0	1	2
OG0001425	2	0	0	0	2
OG0001426	2	0	0	0	2
OG0001427	1	0	1	0	2
OG0001428	1	1	0	0	2
OG0001429	1	0	0	1	2
OG0001430	2	0	0	0	2
OG0001431	2	0	0	0	2
OG0001432	2	0	0	0	2
OG0001433	1	0	0	1	2
OG0001434	2	0	0	0	2
OG0001435	1	0	0	1	2
OG0001436	2	0	0	0	2
OG0001437	1	0	0	1	2
OG0001438	2	0	0	0	2
OG0001439	2	0	0	0	2
OG0001440	2	0	0	0	2
OG0001441	2	0	0	0	2
OG0001442	1	0	0	1	2
OG0001443	1	0	0	1	2
OG0001444	1	0	0	1	2
OG0001445	2	0	0	0	2
OG0001446	2	0	0	0	2
OG0001447	2	0	0	0	2
OG0001448	1	0	1	0	2
OG0001449	2	0	0	0	2
OG0001450	2	0	0	0	2
OG0001451	2	0	0	0	2
OG0001452	1	0	1	0	2
OG0001453	2	0	0	0	2
OG0001454	2	0	0	0	2
OG0001455	2	0	0	0	2
OG0001456	2	0	0	0	2
OG0001457	1	0	0	1	2
OG0001458	2	0	0	0	2
OG0001459	1	0	0	1	2
OG0001460	2	0	0	0	2
OG0001461	2	0	0	0	2
OG0001462	2	0	0	0	2
OG0001463	2	0	0	0	2
OG0001464	2	0	0	0	2
OG0001465	2	0	0	0	2
OG0001466	2	0	0	0	2
OG0001467	2	0	0	0	2
OG0001468	1	0	0	1	2
OG0001469	2	0	0	0	2
OG0001470	2	0	0	0	2
OG0001471	2	0	0	0	2
OG0001472	1	1	0	0	2
OG0001473	2	0	0	0	2
OG0001474	2	0	0	0	2
OG0001475	2	0	0	0	2
OG0001476	2	0	0	0	2
OG0001477	1	0	0	1	2
OG0001478	2	0	0	0	2
OG0001479	2	0	0	0	2
OG0001480	1	0	1	0	2
OG0001481	2	0	0	0	2
OG0001482	1	0	0	1	2
OG0001483	1	0	1	0	2
OG0001484	1	0	0	1	2
OG0001485	2	0	0	0	2
OG0001486	2	0	0	0	2
OG0001487	1	0	1	0	2
OG0001488	2	0	0	0	2
OG0001489	1	0	0	1	2
OG0001490	1	0	0	1	2
OG0001491	2	0	0	0	2
OG0001492	2	0	0	0	2
OG0001493	2	0	0	0	2
OG0001494	2	0	0	0	2
OG0001495	2	0	0	0	2
OG0001496	2	0	0	0	2
OG0001497	1	0	1	0	2
OG0001498	1	0	0	1	2
OG0001499	2	0	0	0	2
OG0001500	1	0	0	1	2
OG0001501	2	0	0	0	2
OG0001502	1	0	0	1	2
OG0001503	2	0	0	0	2
OG0001504	1	0	1	0	2
OG0001505	1	0	0	1	2
OG0001506	1	0	1	0	2
OG0001507	2	0	0	0	2
OG0001508	2	0	0	0	2
OG0001509	1	0	1	0	2
OG0001510	1	0	1	0	2
OG0001511	1	0	0	1	2
OG0001512	1	0	1	0	2
OG0001513	1	0	0	1	2
OG0001514	2	0	0	0	2
OG0001515	1	0	0	1	2
OG0001516	2	0	0	0	2
OG0001517	2	0	0	0	2
OG0001518	2	0	0	0	2
OG0001519	1	0	0	1	2
OG0001520	1	0	0	1	2
OG0001521	1	0	0	1	2
OG0001522	1	0	0	1	2
OG0001523	2	0	0	0	2
OG0001524	1	0	0	1	2
OG0001525	1	1	0	0	2
OG0001526	1	0	0	1	2
OG0001527	1	0	1	0	2
OG0001528	2	0	0	0	2
OG0001529	2	0	0	0	2
OG0001530	1	0	0	1	2
OG0001531	2	0	0	0	2
OG0001532	1	0	0	1	2
OG0001533	1	0	0	1	2
OG0001534	1	0	0	1	2
OG0001535	2	0	0	0	2
OG0001536	2	0	0	0	2
OG0001537	1	0	1	0	2
OG0001538	2	0	0	0	2
OG0001539	2	0	0	0	2
OG0001540	1	0	1	0	2
OG0001541	1	0	0	1	2
OG0001542	2	0	0	0	2
OG0001543	1	0	1	0	2
OG0001544	1	0	0	1	2
OG0001545	2	0	0	0	2
OG0001546	1	0	0	1	2
OG0001547	1	0	0	1	2
OG0001548	2	0	0	0	2
OG0001549	1	0	1	0	2
OG0001550	2	0	0	0	2
OG0001551	2	0	0	0	2
OG0001552	2	0	0	0	2
OG0001553	1	0	1	0	2
OG0001554	1	0	0	1	2
OG0001555	1	0	0	1	2
OG0001556	2	0	0	0	2
OG0001557	1	0	0	1	2
OG0001558	2	0	0	0	2
OG0001559	1	0	0	1	2
OG0001560	2	0	0	0	2
OG0001561	2	0	0	0	2
OG0001562	2	0	0	0	2
OG0001563	2	0	0	0	2
OG0001564	1	1	0	0	2
OG0001565	1	1	0	0	2
OG0001566	1	1	0	0	2
OG0001567	1	1	0	0	2
OG0001568	2	0	0	0	2
OG0001569	1	1	0	0	2
OG0001570	1	0	0	1	2
OG0001571	2	0	0	0	2
OG0001572	1	0	1	0	2
OG0001573	1	0	1	0	2
OG0001574	1	0	0	1	2
OG0001575	2	0	0	0	2
OG0001576	1	0	1	0	2
OG0001577	1	0	1	0	2
OG0001578	1	0	0	1	2
OG0001579	2	0	0	0	2
OG0001580	2	0	0	0	2
OG0001581	1	0	0	1	2
OG0001582	1	1	0	0	2
OG0001583	1	1	0	0	2
OG0001584	2	0	0	0	2
OG0001585	2	0	0	0	2
OG0001586	1	0	0	1	2
OG0001587	1	0	0	1	2
OG0001588	2	0	0	0	2
OG0001589	2	0	0	0	2
OG0001590	1	0	0	1	2
OG0001591	2	0	0	0	2
OG0001592	2	0	0	0	2
OG0001593	1	0	0	1	2
OG0001594	1	0	1	0	2
OG0001595	1	0	0	1	2
OG0001596	2	0	0	0	2
OG0001597	2	0	0	0	2
OG0001598	1	0	0	1	2
OG0001599	2	0	0	0	2
OG0001600	1	0	0	1	2
OG0001601	1	0	0	1	2
OG0001602	1	0	1	0	2
OG0001603	1	0	0	1	2
OG0001604	1	0	1	0	2
OG0001605	1	0	0	1	2
OG0001606	1	0	1	0	2
OG0001607	2	0	0	0	2
OG0001608	1	0	0	1	2
OG0001609	2	0	0	0	2
OG0001610	2	0	0	0	2
OG0001611	2	0	0	0	2
OG0001612	1	0	0	1	2
OG0001613	1	1	0	0	2
OG0001614	1	0	0	1	2
OG0001615	1	0	0	1	2
OG0001616	2	0	0	0	2
OG0001617	2	0	0	0	2
OG0001618	1	0	0	1	2
OG0001619	2	0	0	0	2
OG0001620	1	0	1	0	2
OG0001621	1	0	0	1	2
OG0001622	1	0	1	0	2
OG0001623	2	0	0	0	2
OG0001624	2	0	0	0	2
OG0001625	1	0	0	1	2
OG0001626	1	0	0	1	2
OG0001627	1	0	0	1	2
OG0001628	1	0	0	1	2
OG0001629	1	0	0	1	2
OG0001630	1	0	0	1	2
OG0001631	1	0	0	1	2
OG0001632	2	0	0	0	2
OG0001633	1	0	0	1	2
OG0001634	1	0	0	1	2
OG0001635	1	0	0	1	2
OG0001636	1	0	0	1	2
OG0001637	2	0	0	0	2
OG0001638	1	0	0	1	2
OG0001639	1	0	0	1	2
OG0001640	1	0	0	1	2
OG0001641	1	0	0	1	2
OG0001642	2	0	0	0	2
OG0001643	1	0	1	0	2
OG0001644	1	0	0	1	2
OG0001645	1	0	1	0	2
OG0001646	2	0	0	0	2
OG0001647	1	0	0	1	2
OG0001648	2	0	0	0	2
OG0001649	1	0	0	1	2
OG0001650	2	0	0	0	2
OG0001651	2	0	0	0	2
OG0001652	1	0	0	1	2
OG0001653	1	0	0	1	2
OG0001654	1	0	1	0	2
OG0001655	2	0	0	0	2
OG0001656	1	0	1	0	2
OG0001657	1	0	0	1	2
OG0001658	1	0	0	1	2
OG0001659	1	0	1	0	2
OG0001660	1	1	0	0	2
OG0001661	1	0	0	1	2
OG0001662	1	0	1	0	2
OG0001663	2	0	0	0	2
OG0001664	1	0	0	1	2
OG0001665	2	0	0	0	2
OG0001666	1	0	1	0	2
OG0001667	1	0	0	1	2
OG0001668	2	0	0	0	2
OG0001669	1	0	0	1	2
OG0001670	2	0	0	0	2
OG0001671	1	0	0	1	2
OG0001672	1	0	0	1	2
OG0001673	2	0	0	0	2
OG0001674	1	0	1	0	2
OG0001675	1	0	0	1	2
OG0001676	2	0	0	0	2
OG0001677	1	0	0	1	2
OG0001678	1	0	0	1	2
OG0001679	2	0	0	0	2
OG0001680	1	1	0	0	2
OG0001681	2	0	0	0	2
OG0001682	2	0	0	0	2
OG0001683	1	0	1	0	2
OG0001684	1	0	0	1	2
OG0001685	1	0	0	1	2
OG0001686	1	0	1	0	2
OG0001687	1	0	1	0	2
OG0001688	1	0	1	0	2
OG0001689	1	0	1	0	2
OG0001690	1	0	1	0	2
OG0001691	1	1	0	0	2
OG0001692	2	0	0	0	2
OG0001693	2	0	0	0	2
OG0001694	2	0	0	0	2
OG0001695	2	0	0	0	2
OG0001696	2	0	0	0	2
OG0001697	2	0	0	0	2
OG0001698	2	0	0	0	2
OG0001699	2	0	0	0	2
OG0001700	2	0	0	0	2
OG0001701	2	0	0	0	2
OG0001702	2	0	0	0	2
OG0001703	1	1	0	0	2
OG0001704	2	0	0	0	2
OG0001705	2	0	0	0	2
OG0001706	2	0	0	0	2
OG0001707	1	1	0	0	2
OG0001708	1	0	0	1	2
OG0001709	1	0	1	0	2
OG0001710	1	0	0	1	2
OG0001711	1	0	1	0	2
OG0001712	1	0	0	1	2
OG0001713	1	0	0	1	2
OG0001714	1	0	0	1	2
OG0001715	1	0	0	1	2
OG0001716	2	0	0	0	2
OG0001717	2	0	0	0	2
OG0001718	1	0	0	1	2
OG0001719	2	0	0	0	2
OG0001720	1	0	0	1	2
OG0001721	2	0	0	0	2
OG0001722	2	0	0	0	2
OG0001723	2	0	0	0	2
OG0001724	2	0	0	0	2
OG0001725	1	1	0	0	2
OG0001726	2	0	0	0	2
OG0001727	2	0	0	0	2
OG0001728	2	0	0	0	2
OG0001729	1	0	1	0	2
OG0001730	2	0	0	0	2
OG0001731	1	0	0	1	2
OG0001732	1	0	0	1	2
OG0001733	1	0	0	1	2
OG0001734	1	1	0	0	2
OG0001735	1	1	0	0	2
OG0001736	1	0	1	0	2
OG0001737	1	0	0	1	2
OG0001738	1	0	0	1	2
OG0001739	1	0	0	1	2
OG0001740	1	0	0	1	2
OG0001741	1	0	1	0	2
OG0001742	1	1	0	0	2
OG0001743	1	0	0	1	2
OG0001744	1	1	0	0	2
OG0001745	0	1	0	1	2
OG0001746	0	1	0	1	2
OG0001747	0	1	0	1	2
OG0001748	0	2	0	0	2
OG0001749	0	1	0	1	2
OG0001750	0	1	1	0	2
OG0001751	0	0	2	0	2
OG0001752	0	0	0	2	2
OG0001753	0	0	0	2	2
